Garage_Cars,Year_Built,Gr_Liv_Area,Total_Bsmt_SF,First_Flr_SF,Wood_Deck_SF,Fireplaces,Garage_Area,Second_Flr_SF,Lot_Area
2,2005,1795,879,879,164,0,578,916,9316
2,2007,1648,1596,1648,162,1,482,0,3843
2,2000,1525,756,769,0,1,440,756,2117
0,2004,1114,1114,1114,0,0,0,0,13072
2,2000,1792,936,962,0,1,451,830,10261
2,1997,1470,794,794,0,0,388,676,13869
3,2007,1828,1822,1828,0,1,774,0,11694
1,1960,1273,1273,1273,483,0,307,0,14680
2,1968,1416,708,708,0,1,776,708,11700
1,1919,2447,804,1699,272,1,336,748,9638
1,1970,992,530,530,112,0,297,462,1533
1,1956,925,925,925,152,0,252,0,8540
2,1920,1086,723,723,0,0,400,363,11340
0,1955,1440,1440,1440,0,0,0,0,12108
2,1960,894,894,894,0,1,396,0,7436
2,1960,1721,988,1721,50,2,626,0,10532
1,1939,1077,991,1077,0,2,205,0,7420
2,1978,1683,918,918,243,1,440,765,11184
0,2004,1080,1080,1080,0,0,0,0,7500
2,1920,1482,650,832,0,0,324,650,9000
2,2001,1568,1568,1568,0,1,564,0,7180
2,2009,1852,900,932,168,1,644,920,8640
2,1960,1264,1268,1264,0,2,461,0,9300
2,2007,1218,1218,1218,168,0,462,0,7500
1,1956,1144,1169,1144,257,0,286,0,8760
3,1996,1820,910,910,318,1,816,910,11050
3,2004,1980,1980,1980,194,1,770,0,16737
2,2002,1511,1368,1511,130,1,398,0,2938
2,1969,1620,780,780,208,0,462,840,10793
1,1935,1378,901,861,54,0,162,517,4080
2,1980,1235,1235,1235,133,3,484,0,3760
2,2006,1456,728,728,0,0,429,728,15578
1,1984,1038,1038,1038,0,0,264,0,3869
3,2005,2500,1168,1168,192,1,683,1332,13543
2,1960,1656,1080,1656,210,2,528,0,31770
2,1999,1607,960,962,169,0,480,645,2645
1,1973,987,483,483,0,0,264,504,1680
2,2003,1932,979,992,0,1,610,940,8749
3,1995,2501,1242,1251,192,1,751,1250,11929
1,1963,912,912,912,0,0,300,0,7791
2,1968,1489,1489,1489,0,1,462,0,9156
2,1999,1252,600,624,0,0,462,628,2160
2,1973,2090,1107,1107,235,2,484,983,10382
3,2007,2674,2630,2674,360,2,762,0,13693
2,1976,1127,1127,1127,0,1,480,0,6500
0,1922,904,683,904,0,0,0,0,10020
3,2007,2122,2108,2122,130,1,938,0,14333
1,1939,1258,560,698,0,0,280,560,9060
2,1948,1495,864,1064,180,0,576,0,8064
2,2005,1400,1400,1400,144,0,612,0,11024
2,1984,833,833,833,431,0,495,0,12887
2,2005,1072,547,1072,0,0,525,0,3675
3,2007,1569,1386,1569,143,1,660,0,3635
2,1962,1116,1116,1116,0,0,440,0,10000
2,1993,1617,1604,1617,0,1,533,0,8012
2,1977,1126,1126,1126,180,0,540,0,15611
2,1996,914,870,914,0,0,576,0,8846
3,1997,2392,1396,1407,0,1,870,985,9452
3,2002,1392,1441,1392,168,1,650,0,10000
3,1970,1652,1652,1652,0,0,928,0,11836
2,1920,1140,1300,1140,0,0,400,0,12900
3,2007,1694,1694,1694,168,0,818,0,12030
2,2004,1430,1430,1430,0,0,624,0,10114
2,1940,2480,920,1240,0,2,400,1240,8145
2,1977,1934,1122,946,0,1,567,988,11900
1,1915,1427,483,741,0,0,379,686,5775
1,1963,1144,1144,1144,0,0,336,0,9204
2,1971,1993,825,1097,0,1,495,896,14803
2,1949,1040,0,1040,0,0,420,0,7200
2,2003,1928,847,847,100,1,434,1081,8200
2,1950,1040,0,1040,0,0,400,0,8544
2,1971,1484,1484,1484,224,1,487,0,12243
1,1948,1416,780,780,221,0,312,636,6000
2,2003,1884,926,1016,0,1,581,868,7000
0,1914,3395,1440,1440,0,0,0,1440,10896
2,1974,2646,1748,2151,641,4,550,495,14330
2,1956,1384,1015,1384,75,0,896,0,13300
2,2003,1760,1760,1760,165,1,583,0,12878
2,2004,1646,1594,1646,128,1,525,0,3811
3,2008,1450,1450,1450,0,0,788,0,7328
2,1996,1100,1100,1100,0,0,462,0,13015
2,2006,1737,851,851,0,0,578,886,8581
2,1952,1385,910,910,0,0,720,475,8520
0,1925,672,432,672,0,0,0,0,8534
2,1963,1075,981,1075,64,0,440,0,11235
2,1951,952,952,952,0,0,840,0,7350
2,2005,1684,1684,1684,495,1,564,0,8849
2,2000,1403,1381,1403,0,0,470,0,8098
3,1999,2214,1090,1090,197,1,646,1124,10566
1,1958,1080,1080,1080,0,0,288,0,9464
2,2005,1248,1248,1248,108,0,438,0,3010
1,1956,936,936,936,0,0,308,0,5868
1,1920,691,691,691,0,0,216,0,5400
2,1953,1644,1416,1644,110,2,418,0,9600
2,2005,1456,728,728,100,1,390,728,10928
3,2006,1905,1905,1905,0,1,788,0,11670
1,1900,1566,930,930,54,0,288,636,9600
1,1954,1062,1062,1062,0,0,297,0,8128
1,1963,984,984,984,145,1,384,0,9100
1,1967,899,864,899,64,0,288,0,7800
3,1967,1584,1584,1584,0,0,792,0,8944
2,1996,1504,1504,1504,115,1,478,0,11883
2,1967,1040,1040,1040,0,1,480,0,11500
2,2007,1648,1596,1648,162,1,525,0,3843
2,1972,2119,689,1378,0,1,583,741,10448
2,1980,936,936,936,49,0,672,0,7200
2,1971,1365,765,765,240,0,440,600,1920
2,1910,1772,725,909,0,0,816,863,10337
2,1950,1040,0,1040,0,0,400,0,8544
2,1994,1022,1022,1022,0,0,747,0,14217
3,2008,1658,1614,1658,144,1,726,0,10206
1,1959,1675,1422,1675,0,2,365,0,15263
2,2003,1626,764,764,0,0,474,862,2448
2,2005,1324,1324,1324,36,0,430,0,18494
2,1999,1430,384,774,0,1,400,656,7750
2,1948,1120,744,792,0,0,480,328,11792
0,1959,1006,1006,1006,0,0,0,0,9000
3,2002,2250,1671,1687,238,1,756,563,13650
1,1949,1461,832,832,0,0,384,629,10800
2,2003,1405,1405,1405,148,1,478,0,3480
2,1994,1592,1556,1592,120,1,484,0,11927
2,2006,1919,1079,1079,0,1,685,840,15611
1,1948,2008,896,1112,103,0,230,896,7800
1,1972,987,483,483,411,0,352,504,1890
2,1993,1169,1160,1169,0,1,402,0,8076
2,2001,1840,944,944,0,0,622,896,12420
1,1955,1520,1156,1520,0,2,364,0,9600
1,1950,1368,1078,1368,0,0,195,0,11767
2,1955,1733,0,1733,0,1,452,0,13680
2,2005,1306,1306,1306,170,1,624,0,5122
2,2004,1490,788,788,100,1,388,702,15384
3,2006,1567,1520,1567,312,1,648,0,3982
2,1978,1902,0,1318,0,0,539,584,8930
0,1930,1092,0,372,0,0,0,720,5600
1,1961,925,0,925,0,0,300,0,7000
2,1982,860,840,860,0,0,528,0,8740
0,1967,1832,1832,1832,0,0,0,0,10773
2,1975,1069,1069,1069,0,1,440,0,4043
2,1978,1456,855,855,26,1,440,601,2280
2,1976,1728,1728,1728,0,0,560,0,9297
1,1965,960,960,960,120,0,432,0,10921
1,1915,1652,686,966,0,0,416,686,10800
2,2003,1440,1432,1440,185,1,467,0,11202
1,1965,864,864,864,0,1,360,0,8281
2,1980,1226,1226,1226,133,1,484,0,3874
0,1922,1414,864,964,0,1,0,0,8248
3,2006,1240,1240,1240,140,0,826,0,8556
4,1961,1622,1249,1622,439,1,1356,0,32463
2,1920,2350,973,1377,0,0,393,973,9600
2,2009,1218,1218,1218,0,0,676,0,7862
1,1968,1211,952,1211,0,1,322,0,8250
2,1976,2048,1958,2048,0,0,776,0,12760
3,2007,2552,2552,2552,130,2,932,0,13891
3,2004,2332,1148,1170,224,1,756,1162,10574
2,1968,1464,732,732,0,0,470,732,8814
2,1970,2117,1205,2117,0,2,550,0,12925
2,1994,1679,1408,1679,224,1,575,0,8125
1,1949,1846,1040,1168,0,1,315,678,10496
3,2007,1880,955,955,168,1,880,925,12217
2,1974,1430,1430,1430,117,2,484,0,19508
2,1999,1431,1431,1431,0,0,666,0,9017
0,1910,796,796,796,328,0,0,0,8777
0,2005,1142,1142,1142,4,0,0,0,7733
2,1918,3112,1360,1360,0,1,795,1360,25419
2,1977,1287,957,1287,302,2,541,0,9360
2,1974,2614,1522,1548,38,1,624,1066,10800
1,1940,1505,883,988,0,0,240,517,9144
2,2003,1626,764,764,0,0,474,862,2268
2,2002,1494,1494,1494,192,1,530,0,12803
1,1960,1118,1118,1118,290,0,264,0,11332
2,1996,1291,1291,1291,307,1,431,0,2887
2,1923,968,968,968,0,0,480,0,8520
2,1966,1200,1174,1200,0,1,440,0,8800
2,2009,1935,832,832,0,0,552,1103,8004
2,2003,1626,764,764,0,0,474,862,2448
2,1957,2515,2035,2515,0,2,484,0,32668
1,1976,1055,1055,1055,0,0,319,0,2280
0,1930,840,672,840,0,1,0,0,4388
3,2007,2088,948,948,100,1,656,1140,8899
2,1969,1844,1844,1844,0,1,540,0,16381
3,2005,2324,1175,1182,147,2,736,1142,11924
1,1923,1432,1022,1432,266,1,216,0,6615
3,2007,1800,1800,1800,210,1,944,0,8232
1,1952,1031,1031,1031,0,0,230,0,7626
2,1994,1540,754,754,140,0,495,786,9109
2,1994,1803,1679,1803,129,2,482,0,9892
2,1968,976,976,976,94,1,504,0,9360
1,1998,1502,1502,1502,0,1,286,0,9763
1,1968,1473,1437,1473,0,2,452,0,25095
2,1999,1749,842,856,140,0,515,893,9272
2,1961,1120,1040,1120,168,0,544,0,6970
1,1966,1056,1056,1056,0,0,384,0,8900
3,2006,1740,1721,1740,0,0,874,0,12228
3,1988,1959,1907,1959,0,0,766,0,11070
2,1925,1351,901,901,0,1,576,450,16287
2,1998,1718,832,885,0,1,427,833,10141
2,1920,846,720,846,0,0,576,0,10800
2,1979,943,943,943,42,2,600,0,7032
0,1967,2650,0,862,0,0,0,1788,7200
1,1959,864,864,864,0,0,308,0,8125
0,1915,1392,1212,1212,0,0,0,180,9900
1,1958,1352,1062,1352,168,0,288,0,6930
2,1977,1456,855,855,0,1,440,601,2349
2,1977,1610,1610,1610,168,2,480,0,10603
2,1915,1716,810,1170,0,0,672,546,9144
2,2006,1444,384,744,100,0,400,700,9802
2,1992,1953,1580,1079,216,2,501,874,53107
1,1960,1081,1081,1081,36,0,401,0,12929
1,1939,1123,732,772,0,0,264,351,6060
1,1958,1095,588,1095,0,0,264,0,10382
1,1946,1639,747,892,0,1,240,747,9350
2,1977,1356,1244,1356,1424,1,528,0,15957
2,2005,1302,1302,1302,110,1,631,0,3903
1,1955,1867,1617,1867,476,3,303,0,10708
2,1940,1196,572,848,0,2,576,348,6000
1,1895,1361,173,825,0,0,185,536,5280
3,1996,4476,2396,2411,171,2,813,2065,15623
1,1948,1456,810,1002,0,1,280,454,7585
2,2007,1266,1266,1266,100,1,388,0,3182
2,2003,1200,1176,1200,0,0,555,0,10083
1,1948,1183,649,679,0,0,308,504,6000
1,1950,864,576,864,0,0,528,0,7200
3,1998,1939,1054,1070,128,1,555,869,11250
2,2000,1430,384,774,100,1,400,656,9967
2,1979,2240,0,1120,154,0,528,1120,7018
3,2006,2389,1054,1054,176,1,672,1335,10672
1,1910,1346,560,796,168,0,384,550,11767
0,1975,1012,976,1012,0,0,0,0,7840
2,1960,1329,1329,1329,0,2,441,0,12285
1,1966,904,876,904,0,0,408,0,7162
3,2009,2690,1365,1365,0,1,864,1325,12350
2,2006,1666,1666,1666,228,1,575,0,6373
1,1958,943,0,943,0,0,308,0,11515
0,1910,1464,504,764,0,0,0,700,9900
2,2004,1733,847,847,144,1,433,886,8577
2,1962,1190,1106,1190,0,0,540,0,7728
2,1977,1004,975,1004,0,0,504,0,10530
2,1958,1570,1395,1570,490,1,441,0,13200
2,1999,1224,1224,1224,0,0,402,0,4500
1,1925,844,844,844,50,0,216,0,5633
2,2007,2152,1582,1582,0,1,728,570,16659
0,1920,1248,624,624,0,0,0,624,5976
3,2005,1614,1614,1614,100,0,878,0,9926
2,1978,2064,2048,2064,200,2,550,0,18559
2,1967,1458,1176,1458,284,1,512,0,9535
2,2003,1480,1480,1480,252,0,620,0,8197
3,2004,2492,2492,2492,226,1,949,0,14836
1,1954,1855,994,1216,182,0,325,639,9525
2,1967,1064,1064,1064,314,1,528,0,11327
1,1910,1022,1022,1022,0,0,280,0,7200
1,1940,1740,800,960,0,2,240,780,13125
1,1978,1055,1061,1055,108,0,319,0,2304
2,1952,2461,1140,1929,0,2,400,532,9724
2,1974,2167,1192,1516,220,2,518,651,17542
2,1959,1652,1592,1652,0,1,510,0,22002
1,1926,904,884,904,0,0,180,0,6000
1,1971,1302,630,630,0,0,280,672,1680
2,2000,1842,985,985,193,1,486,857,8826
2,1968,1488,1488,1488,0,2,552,0,21579
2,1980,2673,1043,1539,178,1,441,1134,12388
2,1970,1442,1442,1442,371,1,615,0,11717
2,1994,1987,1986,1987,262,1,691,0,14303
1,1961,864,864,864,132,1,420,0,8100
2,2007,1392,689,703,0,0,540,689,3180
0,1941,788,788,788,0,2,0,0,7446
3,2007,1564,1564,1564,0,0,814,0,11058
2,1975,1076,1076,1076,0,1,576,0,9216
2,2005,1484,742,742,36,1,390,742,12589
2,1968,2654,1054,1512,0,1,619,1142,11029
1,1936,951,951,951,0,0,327,0,8765
2,1978,1226,1226,1226,223,1,484,0,3880
3,2007,1874,955,955,168,1,880,919,9428
2,2003,2082,1362,1362,280,0,484,720,11426
0,1992,970,912,970,80,0,0,0,10441
2,2006,1141,1141,1141,182,0,484,0,7500
2,1965,2036,2136,2036,0,2,513,0,215245
1,1938,1268,832,832,0,2,250,436,6300
2,1977,1069,1069,1069,0,0,440,0,4043
2,1941,1218,735,869,0,1,440,349,6000
2,1997,2199,1173,1182,0,1,516,1017,9660
2,1986,1088,1074,1088,0,0,461,0,3696
3,2007,1602,1578,1602,0,1,810,0,10200
1,1957,936,936,936,0,0,315,0,8760
2,1960,1561,1561,1561,0,1,463,0,13339
2,1963,1040,1064,1040,0,0,648,0,25286
1,1952,882,720,882,0,0,240,0,11556
1,1900,1141,570,761,0,0,252,380,5925
2,1964,1020,980,1020,0,1,528,0,14149
1,1941,1578,806,958,0,2,240,620,9490
2,1978,2073,1542,2073,349,2,500,0,13175
2,2003,1724,796,806,168,1,616,918,7162
2,1980,1229,561,561,176,1,462,668,1488
1,1970,1092,546,546,0,0,286,546,2001
0,2005,1175,1175,1175,0,0,0,0,13072
3,1968,1560,1560,1560,0,0,792,0,8668
2,1989,1191,1191,1191,112,1,531,0,3907
2,1963,1008,1008,1008,0,0,430,0,9723
1,1969,936,936,936,16,0,288,0,10295
2,1979,1524,1524,1524,140,2,478,0,20270
1,1973,988,462,526,120,0,297,462,1596
2,1925,1040,1040,1040,0,0,320,0,7200
1,1910,1889,925,964,0,1,308,925,10120
2,1991,1709,836,851,0,0,416,858,14067
1,1924,1827,848,1017,27,1,240,810,11737
1,1972,864,864,864,0,0,288,0,9560
2,1986,1982,572,1182,400,1,501,800,13607
2,1908,1252,504,936,104,0,576,316,7438
2,2008,1836,1836,1836,0,1,517,0,8125
2,1996,2122,913,913,0,1,559,1209,11492
1,1950,1337,572,1337,0,1,264,0,9600
1,1918,2264,1100,1100,0,0,408,1164,7755
2,2005,1316,1316,1316,100,1,397,0,10237
0,1970,630,630,630,0,0,0,0,1470
2,1920,3082,824,1687,136,2,672,998,15863
1,1955,1540,1190,1040,0,0,352,500,7150
2,1977,1483,1420,1483,496,2,690,0,20062
2,2007,1316,1316,1316,0,1,440,0,11175
2,2006,1370,1370,1370,120,1,484,0,7132
3,2005,1868,1868,1868,354,1,1085,0,14780
2,1977,1567,1567,1567,264,2,714,0,9819
3,2006,1578,1578,1578,0,1,642,0,13253
3,1993,2000,996,996,190,1,650,1004,9627
2,1998,1839,1195,1195,0,0,486,644,16770
1,1880,2210,1008,1178,0,0,205,1032,9900
3,1941,1350,576,864,0,0,627,486,8375
1,1977,1118,1096,1118,203,1,358,0,9880
1,1963,1052,1052,1052,0,0,311,0,10800
1,1939,2192,720,1052,262,1,240,720,8400
2,1997,1771,864,872,0,0,600,899,13142
0,1911,1964,940,1024,0,0,0,940,8525
3,1988,2183,1204,1377,0,0,786,806,13837
2,1950,2161,832,1218,0,2,506,943,12392
2,1972,2704,1952,2000,269,3,538,704,13860
2,1980,1102,988,1102,140,1,582,0,10464
3,1996,2538,1325,1335,198,1,933,1203,9044
1,1950,2315,1168,1278,0,3,342,1037,15600
3,2007,2332,1682,1742,196,1,846,590,12474
3,2008,1932,1932,1932,0,1,774,0,12444
2,2006,1314,1314,1314,0,1,440,0,9317
2,1932,2727,853,1549,0,2,440,1178,10570
2,1994,990,990,990,0,0,672,0,9245
1,1958,1344,1024,1344,316,1,484,0,9503
2,1966,1643,1182,1643,339,1,438,0,11500
2,1978,941,941,941,0,0,564,0,8604
2,2007,1584,1574,1584,0,1,594,0,10440
1,1925,1369,672,697,147,0,300,672,6629
2,1977,1055,1055,1055,0,0,440,0,2529
1,1938,816,816,816,0,1,288,0,8877
2,1966,1567,1562,1567,0,2,542,0,14695
2,1966,1632,800,800,0,0,484,832,9130
4,1971,872,858,872,0,0,480,0,8294
2,2003,1728,864,864,216,0,673,864,8791
2,1941,1355,728,760,0,0,528,595,6221
2,1949,893,845,893,0,0,576,0,9600
3,2005,1953,1082,1082,160,1,1043,871,10574
3,2001,1541,1541,1541,468,1,843,0,13704
4,2000,2787,1168,1168,312,2,820,1619,7976
2,2006,1846,1836,1846,0,1,495,0,13377
2,2003,2327,1129,1129,0,1,596,1198,10905
2,1910,1680,856,936,56,1,450,744,6048
2,1976,1868,780,1088,448,1,484,780,10304
1,1922,1077,1007,1077,0,1,210,0,9786
1,1962,1431,1099,1431,64,1,296,0,9150
1,1972,864,864,864,0,0,297,0,7200
2,2002,1909,872,872,0,0,529,1037,8726
2,2006,1525,1510,1525,100,1,534,0,10936
2,1990,1398,1398,1398,0,0,542,0,7175
1,1954,1470,941,997,0,0,548,473,8172
1,1946,930,0,930,0,0,308,0,11100
2,1910,2291,1214,1260,0,1,506,1031,7200
2,1959,1902,1902,1902,0,2,567,0,17500
1,1942,1150,799,799,264,2,215,351,6488
1,1917,1224,689,725,0,0,180,499,10632
3,2007,1563,1563,1563,144,1,758,0,10206
1,1936,1344,896,896,200,0,240,448,6240
3,2005,1826,1814,1826,180,1,758,0,11302
2,1986,1256,1256,1256,282,1,578,0,18265
3,2005,2758,1704,1722,282,1,814,1036,13654
2,1962,1382,1362,1382,0,1,884,0,19296
1,1937,1497,825,825,272,0,672,672,6000
2,2000,1512,756,756,0,0,440,756,2998
3,1915,1416,876,876,418,1,720,540,12665
3,2007,1651,1643,1651,204,1,870,0,9178
3,2005,1822,1822,1822,0,1,678,0,14122
2,1967,1584,1584,1584,0,0,506,0,8917
1,1910,1609,796,825,0,0,228,784,4347
1,1915,1403,698,754,0,0,308,649,10320
2,2001,1310,1310,1310,277,1,545,0,4538
2,1985,2432,1216,1216,200,0,616,1216,7700
1,1950,1238,864,1238,0,1,357,0,7200
2,1981,1882,0,964,0,2,612,918,8250
3,1970,904,864,904,143,0,912,0,10200
3,1935,894,894,894,0,0,1248,0,18000
2,1996,936,920,936,0,0,460,0,6710
2,1976,1083,1047,1083,444,1,596,0,9927
2,1954,1383,0,1383,0,0,498,0,15635
2,2001,1491,1491,1491,120,0,490,0,9116
0,1946,334,0,334,0,0,0,0,5000
2,1984,1822,1105,1105,0,1,515,717,23920
1,1934,816,816,816,228,1,240,0,8550
2,2006,1500,1489,1500,144,1,674,0,8760
2,1925,1641,728,832,0,1,546,809,9600
1,1945,1529,0,1088,92,0,240,441,8405
2,1965,925,912,925,233,0,576,0,8125
2,1988,1020,1004,1020,135,0,509,0,3907
1,1954,936,936,936,0,0,240,0,9888
1,1963,1146,1083,1146,345,1,294,0,10184
2,2009,1692,846,846,208,0,650,846,13159
3,2008,1468,1468,1468,192,1,904,0,9178
1,1920,960,960,960,0,0,308,0,6000
2,1959,1287,1063,1287,364,1,576,0,9830
2,1989,1034,982,1034,141,1,598,0,3907
2,1971,864,864,864,0,0,528,0,9000
2,2005,1274,1274,1274,264,0,508,0,8814
1,1946,1389,651,707,0,2,240,682,3378
1,1941,1646,918,918,0,2,240,728,7128
1,1976,1113,1143,1113,370,1,504,0,7917
2,1962,980,980,980,0,0,400,0,9750
1,1900,1017,346,709,0,0,308,308,9143
2,1999,2060,992,1022,0,1,390,1038,8755
1,1941,1298,720,854,84,2,256,444,8212
1,1959,1148,1148,1148,0,0,672,0,7931
2,1988,1752,559,1080,325,0,492,672,12134
1,1960,1383,1383,1383,0,0,292,0,11600
2,1900,1174,680,680,116,1,576,494,9000
2,1958,1866,1866,1866,0,0,495,0,9482
1,1949,720,0,720,0,0,287,0,6627
2,1996,2260,1306,1306,296,0,533,954,14000
3,2007,1660,1660,1660,133,1,660,0,10625
2,1963,1053,1053,1053,240,0,692,0,8250
2,1971,864,864,864,200,0,576,0,9000
3,2006,1662,1652,1662,168,1,711,0,10625
0,1910,1594,828,828,0,0,0,658,11426
2,1997,1688,616,616,403,0,603,1072,12798
2,1973,1365,765,765,0,1,440,600,2160
2,1996,1384,1348,1384,0,0,404,0,14137
2,1957,1824,1824,1824,0,0,484,0,12436
1,1954,1204,416,1204,0,0,312,0,7692
2,1978,1174,864,1174,211,0,528,0,12250
2,2003,1829,941,941,192,1,613,888,9548
2,1998,2263,1141,1165,144,1,420,1098,12090
1,1965,984,984,984,0,0,310,0,9308
2,2005,2318,960,960,0,1,541,1358,9512
3,1992,2826,1334,1520,177,3,888,1306,11025
2,1998,1680,1650,1680,78,1,583,0,10140
2,2006,1151,1141,1151,0,0,484,0,3523
2,1952,944,0,944,0,0,528,0,10206
2,2005,1145,1145,1145,100,1,397,0,3182
0,1962,1025,1025,1025,96,0,0,0,7000
2,2001,1296,1267,1296,192,0,471,0,6853
2,1920,2792,1510,1584,0,2,520,1208,10440
2,1929,715,715,715,0,0,660,0,10914
2,2004,1432,716,716,100,1,432,716,7795
1,1939,884,884,884,0,0,240,0,6120
2,1965,1042,1042,1042,192,0,440,0,9200
2,1995,1498,691,691,315,1,409,807,13031
1,1975,924,924,924,0,0,280,0,7990
1,1930,912,520,912,0,0,360,0,7392
2,1984,1177,1153,1177,204,0,495,0,11850
2,1954,832,832,832,0,0,528,0,7227
2,1925,1208,780,848,0,0,539,0,6240
2,1975,1210,1128,1210,0,0,528,0,11080
2,2007,1392,689,703,0,0,540,689,3604
1,1973,1092,525,525,144,0,264,567,2205
2,1967,2978,710,1898,240,1,564,1080,11275
2,2002,1960,860,860,288,2,440,1100,7851
1,1983,816,816,816,330,0,264,0,11625
1,1957,1314,1314,1314,250,0,294,0,8400
2,1981,1707,1686,1707,574,1,511,0,16669
2,2005,1072,547,1072,0,0,525,0,3675
2,1953,1630,1073,1630,0,1,649,0,22692
1,1912,2230,795,954,0,0,440,795,6204
1,1946,896,0,896,0,0,280,0,5940
2,1979,1513,0,1513,0,0,400,0,7007
2,1882,1742,916,916,0,1,424,826,17671
2,2004,1114,1114,1114,248,0,576,0,13072
1,1957,928,928,928,0,0,288,0,6000
1,1960,1149,1014,1149,0,0,544,0,10682
0,1915,1344,536,808,42,0,0,536,10320
2,1992,1280,1280,1280,0,0,506,0,5005
2,2006,1504,1504,1504,144,0,510,0,10936
1,1923,1502,602,900,96,2,180,602,10592
1,1955,1661,992,1661,0,1,377,0,9600
2,1961,1254,1218,1254,0,1,525,0,9600
2,2004,1378,1378,1378,160,1,540,0,4379
2,1951,2136,2136,2136,0,0,528,0,10680
2,2005,1456,728,728,36,1,410,728,8199
3,2007,1530,1530,1530,212,1,984,0,12606
2,1965,1786,1499,1619,670,2,529,167,164660
3,2007,1734,1734,1734,0,1,928,0,12085
2,1997,1837,941,941,150,0,688,896,8304
2,1969,1164,1164,1164,0,0,528,0,9600
3,2002,1800,1800,1800,270,1,765,0,14331
1,1917,1288,624,664,0,1,280,624,3600
2,1976,1664,832,832,0,1,528,832,10140
1,1964,934,912,934,77,0,336,0,10366
1,1980,1217,626,626,0,1,288,591,10762
3,2004,2956,1706,1718,194,1,916,1238,13069
3,2005,2868,1992,1992,214,1,716,876,16056
2,1939,1558,690,868,0,1,400,690,6406
2,2002,1414,707,707,100,1,403,707,7750
1,1940,1672,981,1014,0,1,240,658,6000
2,1984,1522,1190,1522,0,1,552,0,11075
2,2005,1555,1373,1555,143,1,430,0,3182
2,1955,825,825,825,140,0,720,0,8235
1,1955,1411,1204,1411,278,1,310,0,12198
2,1962,1045,1045,1045,0,0,528,0,7400
0,1875,1020,780,780,0,0,0,240,6342
2,1952,948,948,948,0,0,410,0,10950
2,2000,1664,953,953,100,1,460,711,8121
0,1910,1140,576,792,0,0,0,348,8800
1,1926,1013,992,1013,0,0,160,0,5000
2,2004,848,848,848,149,1,420,0,4426
3,2007,4676,3138,3138,208,1,884,1538,40094
2,1971,1645,715,930,0,0,441,715,9600
0,1920,936,936,936,51,1,0,0,4485
2,1969,1404,1188,1404,0,1,504,0,13383
2,1974,2061,1165,1165,0,1,498,896,9600
1,1947,1043,938,1043,125,1,273,0,9724
2,1967,943,943,943,132,0,528,0,8398
2,1992,996,936,996,120,0,564,0,9069
2,1965,1265,1219,1265,0,1,502,0,9350
1,1964,1374,1130,1374,0,1,286,0,11382
1,1966,955,955,955,0,0,386,0,7742
0,1955,784,784,784,112,0,0,0,6931
1,1955,925,923,925,81,2,390,0,8400
2,1980,1564,650,888,0,1,476,676,8400
2,1920,1130,1120,1130,229,1,720,0,10800
1,1921,492,492,492,0,0,200,0,7830
1,1954,1795,1050,1050,0,0,352,745,12150
2,1992,2202,1105,1105,0,1,517,1097,11762
2,1979,1524,1332,1332,268,1,586,192,23595
1,1969,1352,663,663,379,0,299,689,9364
2,2005,1560,684,684,100,1,400,876,11911
3,1978,1282,995,1282,386,0,672,0,10385
3,1995,2520,1203,1214,224,1,721,1306,9950
2,2001,1430,1413,1430,0,0,605,0,16285
2,1998,1753,853,853,0,1,534,900,12352
2,1961,1114,1114,1114,0,0,451,0,9900
2,1985,1240,1265,1240,232,0,528,0,10331
1,1968,909,882,909,0,0,294,0,8450
2,1921,1710,576,902,12,0,480,808,10300
2,2000,1573,756,769,0,0,440,804,2117
2,1915,1962,888,888,160,1,572,1074,8094
2,1983,1338,520,1338,0,1,576,0,19255
3,2008,1736,1736,1736,319,1,834,0,11578
2,1963,2294,741,1497,0,1,658,797,13200
1,1920,1324,662,662,0,0,180,662,3068
0,1990,816,816,816,0,0,0,0,11841
3,2009,2364,2330,2364,0,2,820,0,12919
1,1957,1092,1092,1092,268,1,299,0,14850
3,2008,2184,1104,1130,0,1,836,1054,11308
1,1977,1392,689,689,0,0,299,703,10900
1,1958,864,864,864,0,0,399,0,5400
2,1921,964,876,964,0,0,432,0,13360
0,1947,660,0,660,0,0,0,0,9000
1,1995,1099,1099,1099,278,0,352,0,9525
2,1958,1053,1008,1053,0,0,750,0,8973
2,1949,1040,0,1040,0,0,400,0,8544
2,1963,1088,1088,1088,0,0,520,0,8308
2,1972,1641,1001,1001,0,1,490,640,10759
2,1972,876,876,876,0,0,484,0,7480
2,2004,848,848,848,160,0,420,0,4426
2,1995,1494,1494,1494,0,1,481,0,9549
2,1929,1671,1022,1122,0,1,451,549,8170
2,2004,1594,846,846,300,1,434,748,10125
2,2001,1870,944,944,256,0,608,926,11250
3,1998,3078,1408,1671,108,1,806,1407,10557
2,1950,2158,1202,2158,0,1,576,0,12615
2,1976,1456,855,855,0,1,460,601,2179
2,1928,720,624,720,106,0,484,0,8520
2,2002,1828,1822,1828,194,1,523,0,12782
1,1976,1475,550,925,92,1,336,550,2665
3,1996,2344,1264,1277,220,1,889,1067,10208
1,1993,1091,384,1091,280,0,429,0,7706
2,2006,1689,1689,1689,100,0,433,0,8368
2,1997,1600,916,916,100,1,460,684,8773
2,1964,1806,780,993,0,0,483,813,7570
2,2004,1114,1114,1114,0,0,576,0,13695
2,2005,1072,547,1072,0,0,525,0,3675
0,2002,914,914,914,32,0,0,0,8050
2,1972,1395,723,735,294,1,497,660,12936
1,1938,1582,952,994,189,1,250,588,6120
2,1999,2291,975,1005,192,1,429,1286,8738
2,2003,1479,1453,1479,144,0,558,0,10665
2,1927,1296,845,866,0,0,576,430,6000
1,1914,1784,747,892,203,0,180,892,13132
2,2005,1778,1573,1778,123,1,495,0,5748
2,1977,1967,1967,1967,170,0,580,0,9662
1,1921,1436,585,851,184,1,228,585,6720
2,1971,1824,1643,1824,380,2,739,0,115149
2,2005,1362,1362,1362,192,1,460,0,7577
2,1993,1594,1594,1594,190,1,472,0,9547
3,2008,1696,1696,1696,120,0,972,0,11194
2,1974,1103,1103,1103,295,0,462,0,10000
1,1966,1051,1051,1051,182,0,264,0,9759
2,1984,1232,1232,1232,0,0,516,0,11120
0,1968,1768,1768,1768,0,0,0,0,10778
2,1976,1872,0,936,0,0,484,936,10260
2,1953,2287,1304,1304,0,1,667,983,15593
1,1955,1216,1216,1216,0,0,336,0,10050
1,1915,1944,672,1272,24,0,216,672,9928
2,2007,1588,725,725,0,0,561,863,10411
1,1900,1039,405,717,0,0,281,322,8146
1,1994,990,990,990,256,0,384,0,8428
1,1968,874,864,874,33,0,288,0,9858
1,1918,1250,686,686,207,0,280,564,8248
2,1993,2786,1848,1827,294,1,636,959,11025
3,2007,2696,1264,1282,120,1,792,1414,9965
2,2001,1677,827,827,0,0,627,850,8450
2,1954,1297,1297,1297,0,1,498,0,8532
2,1999,1501,744,757,0,1,440,744,2280
2,2004,1414,1414,1414,132,0,494,0,8773
4,1969,2634,1248,1338,0,0,968,1296,11643
1,1945,1558,913,1048,0,1,288,510,10930
2,1993,1949,1050,1062,156,1,574,887,9938
2,2002,1995,854,864,264,1,435,1131,8740
1,1960,1242,1242,1242,0,0,324,0,7903
2,1959,1194,655,1194,0,1,539,0,8910
1,1961,1144,864,1144,165,1,264,0,10000
1,1959,864,864,864,168,0,288,0,7332
2,1968,1740,1740,1740,25,1,512,0,11050
2,1964,1128,1302,1128,0,1,480,0,18160
0,1970,630,630,630,0,0,0,0,1533
2,2005,1236,600,600,0,0,480,636,2544
1,1925,1078,1054,1078,0,0,264,0,10230
1,1961,1236,912,1236,0,1,288,0,6993
2,2004,1720,860,860,0,0,565,860,11645
2,1890,2554,718,1576,0,0,704,978,10800
3,2007,1966,1966,1966,76,1,1092,0,12291
2,1978,1891,1224,1287,0,1,678,604,18837
2,1976,1743,966,1743,646,2,529,0,20064
1,1951,1216,1056,1216,0,0,280,0,9600
2,1993,1680,886,886,144,0,474,794,8480
2,1987,1137,1112,1137,125,1,551,0,13811
0,1914,1355,684,773,136,0,0,582,6882
2,1963,1464,520,1464,302,1,480,0,12886
3,1998,2630,1470,1470,0,1,696,1160,9200
2,1989,1644,1518,1644,80,1,569,0,12800
2,1928,1913,896,1172,0,1,342,741,7558
2,1984,1360,1220,1360,63,1,565,0,5814
2,1961,1576,1208,1576,85,1,368,0,11475
0,1970,1092,546,546,0,0,0,546,1900
1,1937,1376,780,780,0,1,198,596,8600
2,1987,1204,1191,1204,120,0,461,0,3701
2,1998,1632,935,955,0,1,462,677,9084
2,2002,1409,1409,1409,0,1,576,0,12864
2,1920,2654,671,1567,128,1,638,1087,16779
0,1914,864,864,864,0,0,0,0,8248
2,1991,1755,975,975,502,1,524,780,11949
3,2008,2036,2190,2036,90,1,780,0,13438
2,1958,1315,808,838,0,0,436,477,4330
1,1938,954,920,954,0,1,240,0,6305
1,1986,1295,0,1295,0,0,312,0,8239
1,1910,1360,680,680,192,0,330,680,4800
2,2003,1518,1518,1518,185,1,588,0,12677
2,1880,2016,0,1288,0,1,576,728,26400
1,1900,2007,917,1090,0,0,357,917,8400
2,1992,1730,816,833,0,0,528,897,7703
2,1993,1655,763,763,157,1,440,892,10000
2,1999,1714,923,947,256,1,451,767,8637
1,1952,1624,1444,1624,0,1,240,0,10858
2,2001,1601,1581,1601,180,1,670,0,11423
1,1958,1056,1056,1056,0,0,308,0,8176
3,2007,1950,1950,1950,156,1,706,0,14418
2,2009,1358,1358,1358,192,1,484,0,6371
3,2004,1530,1530,1530,144,1,630,0,14572
2,1957,1721,1331,1721,0,3,464,0,9736
1,1976,836,836,836,150,0,345,0,2104
2,1993,1719,1719,1719,122,2,473,0,10846
3,1991,2127,1104,912,72,1,833,1215,13125
1,1967,912,912,912,0,1,336,0,8521
2,1951,900,900,900,222,0,576,0,7200
1,1954,1383,1383,1383,511,1,354,0,13284
1,1960,894,894,894,0,0,312,0,8680
2,2005,1614,1614,1614,100,1,576,0,9316
2,1964,1298,1250,1298,0,0,504,0,11200
2,1964,1292,1292,1292,0,2,520,0,10500
1,1910,1928,1020,908,0,0,440,1020,9142
2,1996,1446,729,729,264,1,406,717,21872
2,1996,1756,872,888,144,0,422,868,9303
1,1963,999,925,999,40,0,308,0,11235
3,2006,1686,1686,1686,266,1,899,0,7740
0,1970,630,630,630,0,0,0,0,1936
2,2003,1922,0,495,0,1,672,1427,7301
2,1984,1284,1284,1284,0,0,480,0,10960
2,2004,1720,840,840,100,1,440,880,8244
2,2006,1576,770,778,0,0,614,798,8125
2,1965,2380,1021,1465,0,1,596,915,18450
2,1984,2090,1190,1190,219,1,577,900,5062
2,1966,1154,1154,1154,0,1,480,0,11000
3,1998,2612,1225,1276,250,1,676,1336,12203
2,2000,1659,1501,1659,212,1,499,0,5664
2,1999,1513,1462,1513,135,1,521,0,15750
1,1958,1170,1170,1170,0,1,338,0,7315
2,2000,1430,384,774,180,1,400,656,7750
2,1954,1086,1086,1086,0,0,490,0,10200
2,1990,1442,1424,1442,0,0,500,0,11851
1,1965,1256,1256,1256,736,0,276,0,9937
1,1920,1374,840,840,0,0,338,534,5400
0,1970,1092,546,546,0,0,0,546,1495
1,1961,1050,1050,1050,0,0,368,0,10659
2,2005,1368,1368,1368,132,1,474,0,6792
2,1993,1362,796,796,40,0,480,566,14115
2,1949,924,672,672,0,1,576,252,8064
2,1948,1920,928,928,0,0,400,992,11345
2,1923,1902,1100,1226,0,0,576,676,6120
1,1946,1200,768,768,0,0,240,432,11767
2,1939,1352,676,676,187,0,720,676,10800
2,2003,1696,835,835,143,0,542,861,10110
2,1959,1327,1063,1327,0,0,624,0,7388
2,1997,1418,1418,1418,208,1,558,0,8696
1,1962,864,864,864,58,0,294,0,6600
2,2010,1222,1222,1222,0,0,615,0,7360
2,1954,1350,967,1350,237,1,504,0,9375
1,1951,1363,1008,1363,324,2,288,0,14559
1,1952,1064,864,1064,0,0,318,0,10950
2,1988,1688,1675,1688,0,1,528,0,12680
3,2006,1500,1356,1500,161,1,648,0,4045
0,1970,1092,546,546,0,0,0,546,1936
3,1993,2418,1311,1325,250,1,983,1093,10542
2,1937,2267,1005,1262,521,2,498,1005,12888
1,1945,1182,770,885,0,0,378,297,9576
2,1976,1437,1437,1437,0,1,528,0,10768
2,1966,1086,1024,1086,0,1,484,0,13400
2,2003,848,848,848,140,0,420,0,4435
0,1945,729,0,729,0,0,0,0,12366
3,2005,2098,1030,1038,192,1,878,1060,10240
2,1915,2377,1313,1313,0,1,528,0,10410
2,2007,1290,1282,1290,168,1,662,0,6762
1,1972,1092,546,546,0,0,286,546,1890
2,1999,1441,776,764,206,0,492,677,2645
2,2009,1224,612,612,0,0,528,612,3951
3,2005,2504,1122,1134,144,1,656,1370,11198
3,2007,1646,1638,1646,192,1,800,0,9520
2,1967,1568,1568,1568,160,0,440,0,9600
2,2003,848,848,848,140,0,420,0,4435
2,1978,1432,1360,1432,168,1,588,0,16157
2,2007,1369,1369,1369,0,0,605,0,9910
2,2007,1302,1302,1302,0,0,436,0,8993
0,1947,698,698,698,0,0,0,0,9405
1,1965,1040,1040,1040,0,0,384,0,11200
2,1954,2422,1288,2422,0,2,527,0,12671
1,1965,1136,1136,1136,426,1,384,0,9200
2,2002,1776,936,936,144,1,474,840,14006
2,1999,1709,1698,1709,97,1,506,0,5119
0,1919,819,610,819,0,0,0,0,9000
1,1968,864,864,864,226,0,280,0,7832
3,1994,1624,1624,1624,0,1,757,0,12461
2,1973,1178,1176,1178,224,1,439,0,10000
1,1957,1105,1105,1105,0,0,308,0,10454
1,1973,987,483,483,72,0,264,504,1953
2,2003,1114,1114,1114,0,0,576,0,12450
1,1950,1612,988,1030,0,0,363,582,5830
2,1963,1121,1121,1121,0,0,480,0,8816
3,2003,2374,1181,1234,104,1,656,1140,11999
2,1958,1414,1184,1414,0,1,601,0,11029
2,1959,1700,1398,1700,0,1,447,0,10552
0,1895,1534,736,751,0,0,0,783,10800
2,1936,1539,927,1067,112,0,576,472,6120
2,1950,1040,0,1040,0,0,400,0,8544
2,1990,2683,930,1364,237,2,473,1319,9205
2,2004,1358,1358,1358,192,1,484,0,8198
2,1925,1103,1103,1103,166,1,440,0,6000
2,1956,1188,988,1188,102,1,621,0,14175
1,1949,1728,704,1024,245,1,234,704,9462
1,1939,1232,600,608,0,2,217,624,6000
1,1953,1336,1165,1336,0,2,375,0,15750
2,2003,1640,798,798,0,0,595,842,7226
2,1940,1072,808,1072,0,2,379,0,7200
1,1929,1136,704,624,0,0,336,512,6240
2,1950,1040,0,1040,0,0,625,0,7200
1,1971,987,483,483,0,0,264,504,1680
1,1927,1930,720,1146,0,0,316,784,6876
1,1956,2071,825,2071,131,1,336,0,15584
2,2003,2184,1068,1068,192,1,570,1116,12334
3,2006,1670,1670,1670,144,1,690,0,14859
2,1993,1911,777,1065,182,1,471,846,9554
1,1948,1285,672,1072,0,0,240,213,8635
3,2006,1494,1494,1494,160,1,840,0,10652
2,1975,1456,855,855,0,0,460,601,2308
1,1956,1124,1124,1124,0,1,353,0,10152
1,1951,1342,1342,1342,0,0,256,0,9280
3,2006,1970,1085,1120,177,1,753,850,11065
2,2001,1929,1057,1057,0,1,650,872,7050
1,1920,1550,817,940,0,1,318,610,21780
2,2001,1690,845,845,0,0,517,845,9543
3,1980,2014,2014,2014,462,2,864,0,15676
2,1994,1494,1494,1494,0,1,478,0,9466
2,1998,1337,1405,1337,144,0,511,0,4060
3,2007,1571,1571,1571,100,1,722,0,10991
2,1995,1572,806,806,0,1,373,766,10364
2,1910,1650,926,991,128,0,468,659,8398
2,1994,1652,423,896,0,0,473,756,19645
1,1957,922,922,922,0,0,308,0,9770
2,1950,1133,795,765,0,0,900,368,8064
2,1973,1092,525,525,0,0,440,567,2760
2,1972,882,882,882,96,0,461,0,7700
2,2005,1809,945,945,144,0,638,864,10984
1,1954,1112,1112,1112,0,1,390,0,9100
2,1967,1830,1865,1830,0,2,521,0,20355
2,1995,2814,1077,1093,48,1,614,1721,9771
3,2007,1710,1710,1710,0,1,866,0,13891
2,1968,2156,1568,2156,0,1,508,0,20781
2,1986,2730,1502,1553,201,1,576,1177,10380
2,1998,1216,1216,1216,0,0,402,0,4500
2,1977,1040,1040,1040,0,0,748,0,8982
2,2005,1072,547,1072,0,0,525,0,3675
0,1959,1225,950,1225,352,0,0,0,9320
1,1938,886,190,886,144,0,273,0,5784
2,1964,1005,1005,1005,0,0,440,0,14299
2,1969,2080,1040,1040,335,2,504,1040,11606
1,1966,913,814,913,0,0,240,0,8400
1,1965,1024,1024,1024,0,0,308,0,13052
1,1952,1536,768,768,0,0,308,768,10266
1,1920,1740,936,960,0,1,225,780,7308
0,1951,1396,660,1060,0,0,0,336,9000
2,1904,1539,650,958,70,1,686,581,10440
0,1926,1522,1008,1008,0,0,0,0,6000
1,1961,1608,1396,1608,152,0,444,0,27697
2,1930,1536,928,928,0,1,480,608,6240
2,2006,1324,1324,1324,192,1,550,0,6240
1,1950,1203,709,979,0,1,352,224,7015
1,1965,925,925,925,0,0,429,0,9100
1,1922,816,816,816,0,0,100,0,3672
2,1965,1200,864,1200,0,0,884,0,9230
2,2006,1554,1554,1554,156,1,627,0,4590
2,1966,2201,697,1575,586,1,432,626,19690
2,2006,1498,1498,1498,351,0,675,0,8990
0,1959,1678,1678,1678,0,0,0,0,10926
1,1968,897,876,897,0,0,264,0,8665
1,1967,902,876,902,0,0,288,0,6173
2,1950,1488,1488,1488,0,1,738,0,47280
1,1959,984,984,984,0,0,308,0,9750
2,1939,856,856,856,0,1,399,0,7890
1,1956,952,952,952,0,0,283,0,8475
2,1994,1320,636,636,0,0,472,684,9019
0,1940,708,420,708,164,0,0,0,5330
2,1993,1320,630,630,0,0,484,690,3612
2,1977,2872,1330,1542,550,1,619,1330,12227
2,1967,1724,1680,1724,0,1,480,0,17871
1,1958,1093,869,1093,0,0,308,0,8516
2,1977,1117,1029,1117,292,1,542,0,9638
2,1997,1493,1478,1493,140,1,508,0,13125
2,1964,1246,1246,1246,0,2,441,0,12700
1,1926,1461,686,686,0,1,225,775,7155
1,1956,1008,1008,1008,0,0,308,0,6860
2,1940,1436,884,884,0,2,828,552,10800
2,1994,1958,779,1029,202,1,499,929,9317
2,2004,1728,864,864,187,0,572,864,9313
2,1971,874,864,874,63,0,576,0,7200
1,1968,1008,1008,1008,144,0,384,0,12518
1,1968,948,948,948,147,0,300,0,8978
2,1973,2223,2223,2223,300,2,516,0,13651
1,1941,1564,704,860,0,1,234,704,12000
1,1921,616,616,616,0,0,205,0,6000
1,1941,540,480,540,0,0,200,0,8154
1,1955,1382,1382,1382,280,0,350,0,8750
2,2007,1665,813,822,0,0,562,843,8125
2,1963,1382,1051,1382,0,1,459,0,11235
2,1976,1033,456,1033,224,0,504,0,12102
3,1964,1200,1200,1200,0,0,850,0,14137
2,1951,864,864,864,0,0,400,0,19138
2,1979,1535,0,1535,0,0,400,0,7018
2,1995,1474,384,804,120,1,400,670,8530
2,1996,1628,384,958,48,1,390,670,8400
2,2005,1538,1538,1538,146,0,484,0,8847
1,1940,778,740,778,0,1,924,0,6900
2,1966,1209,1209,1209,0,0,504,0,9900
2,2003,1710,856,856,0,0,548,854,8450
1,1930,1004,502,502,280,1,200,502,3960
2,2007,1496,1496,1496,168,0,474,0,9158
0,1940,1355,644,808,140,0,0,547,10106
2,1978,1034,456,1034,0,1,504,0,8014
2,1998,1682,804,804,0,0,523,878,8750
2,1992,1167,1158,1167,120,0,400,0,9248
1,1975,836,836,836,0,0,308,0,2280
3,2004,3005,1376,1376,0,1,704,1629,2880
2,1953,936,936,936,0,0,576,0,6000
1,1960,1248,1248,1248,0,0,286,0,10800
2,1977,1647,1430,1647,0,1,621,0,12984
1,1915,1826,910,916,0,1,164,910,2500
4,1978,2840,1420,1420,0,2,1314,1420,12511
1,1958,1176,1158,1176,0,2,303,0,13770
3,2007,1933,894,894,100,1,668,1039,14598
1,1960,1253,1253,1253,0,1,352,0,10920
3,2003,1978,1978,1978,188,1,850,0,10389
2,1951,876,876,876,0,1,576,0,7200
2,1976,1211,1211,1211,0,1,461,0,13068
2,1910,1250,661,661,242,1,552,589,5362
2,2008,1428,1417,1428,0,0,554,0,12274
3,2006,1685,1685,1685,112,1,658,0,11824
2,2004,1593,839,864,100,1,398,729,7415
0,1912,1560,780,780,344,0,0,780,12900
2,1979,1299,1001,1299,84,1,486,0,12150
1,1964,912,912,912,0,0,288,0,7800
2,1993,1710,832,832,144,0,506,878,9291
2,1965,1039,1039,1039,0,0,504,0,11625
1,1952,924,924,924,0,0,420,0,15783
2,1976,1574,796,790,306,1,566,784,18800
2,1978,912,888,912,0,1,470,0,7540
1,1954,1050,1050,1050,0,0,286,0,8092
1,1918,1228,600,628,0,1,215,600,7155
4,1997,1344,1344,1344,0,0,784,0,8940
2,1983,1260,1260,1260,152,0,598,0,10825
1,1970,630,630,630,0,0,286,0,1477
2,1985,1742,1742,1742,114,1,564,0,6563
2,2007,1800,1800,1800,288,0,702,0,11923
1,1925,1512,798,798,85,1,180,714,7609
1,1946,1230,747,774,0,0,305,456,4712
3,1964,1224,0,1224,0,0,530,0,10899
0,1955,1152,0,1152,0,0,0,0,6040
2,2007,1314,1314,1314,172,1,626,0,5063
2,2008,1456,1451,1456,192,1,539,0,6472
1,1972,987,483,483,250,0,264,504,1680
2,2005,2091,1606,1625,194,1,521,466,9942
2,1994,2622,1463,1500,186,2,712,1122,12256
2,2009,1214,1214,1214,0,0,520,0,9803
3,2006,2042,1742,2042,240,1,724,0,13870
1,1940,1489,778,944,335,1,240,545,9900
2,2006,1489,1489,1489,0,1,776,0,11216
2,1970,1180,1180,1180,0,0,477,0,7830
0,1923,892,858,892,0,0,0,0,5160
2,1981,2524,2524,2524,474,1,542,0,9600
2,2006,1262,1262,1262,0,0,572,0,7200
2,1958,1336,1121,1336,80,1,488,0,9610
2,1976,1680,1680,1680,0,0,528,0,11500
1,1951,1422,806,1081,0,1,288,341,12375
2,1977,1949,1949,1949,32,0,586,0,8235
1,1930,790,768,790,0,0,160,0,6292
2,1910,1944,972,972,0,0,324,972,10307
1,1892,2372,994,1378,0,0,432,994,6600
1,1968,1060,1060,1060,406,1,270,0,8246
1,1960,1377,1377,1377,0,2,351,0,8000
1,1934,1112,585,687,0,0,226,425,9780
2,1900,1812,360,1032,344,1,672,780,7630
3,2000,2687,1455,1466,252,2,810,1221,12720
2,1976,1855,528,1094,113,1,512,761,9600
3,1993,2520,1338,1352,209,1,796,1168,14541
0,1924,1096,572,572,0,0,0,524,9600
1,1941,1111,616,616,48,0,200,495,9084
3,1977,2944,994,1599,140,1,864,1345,24572
2,1978,1707,1140,1707,0,1,479,0,11088
2,2005,1200,600,600,0,0,480,600,3180
1,1972,1092,546,546,0,0,253,546,1504
2,1961,1362,1362,1362,0,1,504,0,10197
1,1925,1666,588,833,192,1,228,833,5100
1,1957,1764,0,1764,0,1,301,0,8838
1,1925,1482,672,810,0,0,400,672,12155
2,1968,1152,912,1152,0,0,412,0,11700
1,1930,984,984,984,0,0,308,0,7200
2,1974,1876,901,943,0,1,540,933,9120
1,1925,1820,1026,1133,0,0,240,687,9120
1,1973,987,483,483,0,0,264,504,1680
2,1934,3194,965,1940,0,2,380,1254,12168
2,1976,958,1078,958,0,1,440,0,4928
3,1994,2448,1629,1686,517,1,711,762,46589
2,2005,2462,1392,1392,239,1,576,1070,19378
2,1987,1433,1433,1433,0,2,528,0,11980
2,2006,1145,1145,1145,100,0,437,0,3203
2,2006,1324,1324,1324,0,1,550,0,6240
2,2007,1314,1314,1314,172,1,626,0,5001
3,2001,1947,1357,1366,168,1,725,581,9720
3,2006,1824,1824,1824,160,1,932,0,12633
1,1920,1111,530,581,0,0,288,530,7200
0,1972,630,630,630,88,0,0,0,1890
3,1915,1717,756,961,0,1,642,756,9550
