Garage_Cars,Year_Built,Gr_Liv_Area,Total_Bsmt_SF,First_Flr_SF,Wood_Deck_SF,Fireplace_Qu_No_Fireplace,Garage_Area,Second_Flr_SF,Lot_Area
2,1996,1553,691,691,0,1,420,862,7875
1,1910,899,481,899,0,1,200,0,6756
3,1916,1344,624,624,0,1,513,720,4571
1,1968,890,890,890,0,1,308,0,8450
1,1941,2133,1528,1225,0,0,312,908,10452
1,1950,1328,768,768,0,1,308,560,6000
3,2003,2392,2392,2392,248,0,968,0,13472
2,2004,2084,956,956,0,1,618,1128,10142
1,1956,1024,1008,1024,0,0,313,0,10533
1,1963,1040,1040,1040,0,1,308,0,7500
0,1961,1800,1800,1800,0,1,0,0,8000
2,1963,1728,1728,1728,0,1,504,0,9100
2,2007,1456,728,728,100,0,400,728,9018
1,1962,864,864,864,0,1,336,0,7000
2,1998,1463,1463,1463,0,1,539,0,14753
3,2006,2172,1063,1071,192,0,947,1101,14154
1,1953,1210,0,1210,208,1,616,0,9533
3,2008,1766,1751,1766,216,0,874,0,11778
1,1954,1056,1056,1056,390,1,260,0,9250
2,1910,1760,1077,981,120,0,648,779,10818
2,1900,1445,676,831,0,1,484,614,14235
2,1954,894,894,894,0,1,400,0,9450
2,1920,1196,684,684,0,1,528,512,12354
1,1920,1738,715,1281,55,0,368,457,12513
3,2003,2200,2200,2200,208,0,685,0,15262
0,1962,1728,1728,1728,0,1,0,0,13260
1,1955,827,0,827,0,0,392,0,7200
2,2004,1948,847,847,100,0,434,1101,12393
3,2008,1254,1254,1254,168,1,810,0,10324
2,2004,848,848,848,140,1,420,0,4426
2,1992,1759,1449,944,150,0,525,815,16698
1,1961,1029,1029,1029,64,1,261,0,7943
1,1938,1374,884,932,64,1,225,442,9260
1,1925,995,960,995,0,1,264,0,6120
2,2008,1652,1600,1652,162,0,482,0,5587
3,2006,2550,1108,1148,120,0,670,1402,13440
2,1969,1336,1288,1336,312,0,502,0,9600
1,1970,1092,546,546,0,1,286,546,1533
2,2006,1394,384,754,100,1,400,640,9735
3,1995,2794,1462,1490,0,0,810,1304,15138
2,1968,2110,2110,2110,0,0,522,0,11160
1,1946,407,407,407,76,1,297,0,7311
2,1936,1466,796,1096,436,0,566,370,10800
2,1916,2134,844,1445,0,1,441,689,11888
3,2004,2473,1143,1143,192,0,852,1330,9591
1,1951,1480,1080,1080,0,0,253,400,11100
2,1977,1212,506,1212,292,0,492,0,8471
3,2008,1694,1694,1694,160,1,776,0,10475
1,1978,1152,1152,1152,0,1,252,0,10547
1,1947,1216,832,832,158,1,336,384,8480
3,2006,1634,1626,1634,0,0,866,0,11428
1,1967,1214,1214,1214,0,0,318,0,10355
1,1920,1513,939,939,24,1,180,574,6120
1,1977,1475,757,925,104,0,336,550,2665
3,1992,2225,1390,1402,198,0,713,823,11134
1,1973,1218,672,672,144,1,264,546,1890
2,1991,1217,1217,1217,0,1,484,0,7175
1,1960,958,958,958,0,1,301,0,12772
1,1963,1068,1059,1068,192,1,264,0,8414
1,1935,1242,583,647,329,0,180,595,5707
0,1920,1406,319,1035,0,1,0,371,7920
3,1998,2385,1066,1108,120,0,600,1277,10790
2,2004,2522,2208,2522,182,0,564,0,7296
2,2006,1250,625,625,0,1,528,625,4251
0,1975,864,864,864,0,1,0,0,9350
1,1972,864,864,864,0,0,338,0,15523
2,1972,1479,725,725,0,1,484,754,7472
0,1971,1218,672,672,201,1,0,546,1680
2,2003,1626,764,764,0,1,474,862,2628
2,1992,1575,1575,1575,0,1,529,0,8012
2,1959,1188,1188,1188,0,1,531,0,12160
1,1958,1524,874,874,0,1,315,650,11344
1,1945,1340,780,816,0,1,440,524,6430
1,1920,1344,672,672,0,1,468,672,10690
0,1938,1053,585,585,42,1,0,468,12180
2,2005,1090,1090,1090,0,1,450,0,7024
2,1976,1456,855,855,87,0,440,601,2280
2,2005,1142,1142,1142,90,1,440,0,3010
2,1975,1040,1040,1040,0,1,499,0,4224
2,2004,1500,1500,1500,192,1,570,0,8487
1,1953,1609,1000,1068,0,1,305,541,9525
2,1931,1774,952,1022,90,0,468,752,6120
2,1953,2259,1809,2259,166,0,450,0,21000
2,1977,1009,995,1009,0,0,576,0,9720
1,1938,1251,827,827,0,1,240,424,6900
2,1934,1176,816,816,112,0,528,0,6240
2,1964,1445,1127,1445,180,0,645,0,12095
1,1949,1523,1067,986,0,0,295,537,15600
2,1967,894,894,894,0,1,450,0,9764
2,1928,784,784,784,0,1,360,0,9000
2,1965,1264,1068,1264,0,0,528,0,15300
3,2008,1641,1641,1641,0,1,885,0,14463
1,1926,1316,644,672,0,0,369,644,8969
3,2003,2696,2846,2696,220,0,958,0,14300
2,1958,2279,585,2279,274,0,461,0,19958
1,1957,1788,1104,1104,120,0,304,684,11250
2,1965,1324,1088,1324,0,0,440,0,8658
2,1900,1627,797,830,192,1,420,797,9142
2,1954,1293,1178,1293,280,1,452,0,11027
2,2005,1844,1844,1844,165,0,620,0,10994
2,2005,1971,1113,1113,0,0,689,858,9675
1,1954,1172,1172,1172,240,1,366,0,9525
3,2003,2690,1765,1804,268,0,795,886,16451
1,1916,952,952,952,0,0,192,0,8854
1,1958,1215,1215,1215,0,1,297,0,12400
3,2006,1939,1095,1095,192,0,1053,844,10728
1,1994,990,990,990,66,1,440,0,9757
1,1906,1469,756,756,57,1,216,713,10320
2,1961,1144,1144,1144,0,1,456,0,7875
3,1925,2640,2171,1392,631,0,1008,1248,22136
3,2007,2574,1482,1482,0,0,868,1092,9588
1,1920,1216,565,565,0,0,355,651,5520
2,2003,1986,847,847,120,0,434,1139,8396
1,1956,1202,1202,1202,0,1,304,0,8750
2,2001,1786,920,920,0,0,608,866,11250
2,2007,1780,920,920,0,0,612,860,12852
2,2000,1512,756,756,0,1,440,756,2980
2,1923,1603,784,819,0,0,599,784,9650
2,2005,1368,1368,1368,132,0,474,0,6955
2,1975,1055,1057,1055,0,0,440,0,2280
3,1998,2006,1982,2006,144,0,938,0,11675
1,1931,1818,1040,1226,0,0,240,592,7758
2,1998,1633,932,932,0,0,460,701,11184
2,2005,1310,1310,1310,0,0,400,0,8767
2,1926,960,850,960,0,1,576,0,6978
2,1989,1982,807,1175,0,0,575,807,11287
2,1998,1465,789,789,0,0,393,676,8402
2,1971,2365,1803,2365,200,0,551,0,17597
2,2000,1630,1630,1630,74,0,451,0,9750
2,1977,1208,1208,1208,198,0,546,0,11250
2,2001,2161,1257,1290,0,0,570,871,10400
2,1982,816,816,816,0,1,816,0,6600
3,2006,1776,1732,1776,0,0,712,0,15306
1,1983,816,816,816,315,1,264,0,6490
0,1920,1027,931,1027,0,0,0,0,5400
2,1937,1131,907,1131,0,1,672,0,5925
0,1895,1991,957,1034,0,1,0,957,8250
1,1920,438,290,438,0,1,246,0,8400
2,2007,1338,1338,1338,0,1,598,0,8640
2,1970,1302,630,630,0,1,440,672,2016
1,1958,792,792,792,0,1,366,0,5470
2,1935,1873,608,983,0,0,786,890,9670
4,1880,2640,1240,1320,181,0,864,1320,11700
3,2007,2161,1582,1610,178,0,789,551,10562
2,1962,1224,0,1224,0,1,462,0,9842
1,1949,1716,768,1148,0,0,281,568,11409
3,2007,1718,1705,1718,208,0,826,0,10637
2,1971,868,768,868,138,1,576,0,8425
2,1970,1277,1277,1277,0,0,526,0,10628
2,1998,1661,1649,1661,0,1,598,0,12137
2,2004,1709,970,970,0,1,380,739,2522
2,1955,864,864,864,0,1,572,0,8172
2,1977,1126,1126,1126,295,0,484,0,17400
0,2006,1143,1143,1143,0,1,0,0,7500
1,1953,1040,1040,1040,0,1,293,0,7942
2,1971,1320,1232,1320,0,0,495,0,16500
0,1910,2256,840,1128,0,1,0,1128,9045
3,1935,3086,666,1308,0,1,1200,1778,21281
0,1925,864,864,864,0,1,0,0,5604
2,2004,1200,600,600,0,1,480,600,3215
3,2007,1818,895,895,196,0,774,923,12568
1,1967,864,864,864,0,1,312,0,7130
2,1969,1851,1851,1851,0,0,506,0,11727
3,2008,2276,2271,2276,0,0,1348,0,11778
2,1910,1432,264,768,270,1,360,664,9600
2,1978,1400,672,672,0,0,440,728,7844
2,2003,1337,1337,1337,0,1,531,0,8450
1,1971,1092,525,525,0,1,264,567,1680
1,1952,1148,980,1148,0,1,308,0,6420
2,1910,1690,560,930,0,1,624,760,7200
1,1958,1632,1240,1632,289,0,338,0,9600
1,1956,882,0,882,0,1,308,0,12702
1,1962,1092,1092,1092,0,0,288,0,11616
2,1994,1657,832,832,144,1,483,825,14565
2,1984,1868,585,1140,268,0,477,728,12090
2,1964,1977,816,1127,0,0,540,850,9500
2,2007,1496,768,768,100,1,572,728,15810
2,2003,1405,1405,1405,136,0,478,0,3242
2,2005,1734,1734,1734,160,1,660,0,11645
3,2003,1944,1896,1944,208,0,708,0,12378
3,2008,1866,1858,1866,0,0,870,0,10110
1,1984,887,864,887,140,1,288,0,10447
3,2010,1856,1856,1856,113,0,834,0,11394
0,1924,784,784,784,0,1,0,0,6130
2,1995,1499,781,795,413,0,473,704,12438
2,1978,1548,804,804,108,0,440,744,2364
1,1955,1393,816,872,121,1,300,521,16466
2,1958,1312,1312,1312,0,0,495,0,11355
2,1984,1621,1208,1621,108,1,440,0,14145
1,1972,987,483,483,0,1,288,504,1680
0,1941,693,693,693,0,1,0,0,4118
1,1959,1357,1019,1357,0,0,312,0,11512
1,1977,907,876,907,0,1,308,0,16300
3,2000,2153,1440,1476,253,0,736,677,11050
0,1958,858,858,858,117,1,0,0,7207
2,2009,1478,1470,1478,0,0,484,0,4403
3,1957,1362,1040,1362,0,0,768,0,9450
1,1966,1228,1228,1228,0,1,271,0,8544
2,1966,1165,1127,1165,0,1,490,0,9020
1,1970,1092,546,546,0,1,286,546,1894
2,2009,1314,1300,1314,135,1,552,0,8640
3,2006,3390,1528,1528,204,0,758,1862,18062
2,2009,1547,756,764,169,1,614,783,8640
1,1977,1304,264,616,141,0,336,688,2665
2,1999,1471,729,742,0,1,440,729,3230
1,1959,960,960,960,144,1,392,0,6400
1,1927,520,520,520,49,1,240,0,6324
1,1932,1520,793,848,0,1,281,672,4500
1,1923,792,624,792,0,1,287,0,8520
2,1962,988,988,988,0,1,624,0,9100
1,1997,1694,569,854,0,0,434,840,8314
2,1994,1895,712,1086,143,0,409,809,10832
2,1999,1804,994,1028,140,0,442,776,7500
2,1962,1537,1319,1537,0,0,462,0,8400
1,1970,987,483,483,0,1,280,504,1869
2,2002,2267,1010,1010,120,0,390,1257,8068
2,1998,1636,952,952,0,0,440,684,7500
2,2009,1212,1212,1212,100,1,460,0,10420
1,1920,1336,637,897,0,1,570,439,11040
2,1963,1796,780,983,0,0,483,813,7056
3,2005,1498,1498,1498,144,0,844,0,11645
3,2004,2443,1158,1158,193,0,744,1285,10625
3,2005,1552,1552,1552,144,1,782,0,10084
1,1947,1284,720,720,0,1,240,564,3500
1,1982,816,816,816,168,1,264,0,8314
1,1918,1426,912,912,0,0,216,514,7642
2,1997,2236,964,993,0,0,642,1243,13006
2,2005,1565,1560,1565,196,0,556,0,5911
2,1996,1491,1491,1491,0,0,571,0,7777
2,2007,1838,1838,1838,154,0,524,0,11422
2,1976,2030,848,1118,0,0,551,912,12046
2,1968,894,894,894,0,0,450,0,8724
2,1977,1285,1243,1285,375,0,473,0,9620
1,1970,630,630,630,0,1,286,0,1526
3,1981,1842,1842,1842,857,0,894,0,50271
1,1962,1269,621,621,0,1,280,648,9360
2,1971,1052,1010,1052,0,1,440,0,8816
1,1915,1647,806,841,0,1,216,806,6858
2,1994,990,990,990,168,1,528,0,9750
2,1920,1167,915,1167,0,0,495,0,8731
2,1985,1732,741,977,192,0,476,755,9206
0,1940,1518,1580,1518,0,0,0,0,19550
0,1975,980,945,980,0,1,0,0,9400
2,1893,2775,1237,1521,105,0,880,1254,13500
2,1996,1661,799,827,158,0,550,834,10667
1,1910,1484,771,866,14,1,264,504,10320
1,1969,1360,1104,1360,160,0,336,0,13384
2,1910,1510,677,833,0,1,720,677,9600
1,1967,936,936,936,405,0,384,0,9825
2,1996,1776,821,821,286,0,443,955,9783
1,1956,1005,1005,1005,0,0,319,0,11050
2,1974,1173,1053,1173,0,0,528,0,10625
2,2005,1220,1220,1220,100,0,397,0,3182
2,1956,1811,1073,1811,0,0,470,0,14115
2,2005,1506,1494,1506,192,0,672,0,8251
1,1972,796,796,796,138,1,336,0,7689
2,1960,1138,1138,1138,0,0,480,0,15312
1,1956,1370,1058,1370,191,0,300,0,10000
2,1988,2060,1151,1164,0,0,521,896,10029
1,1923,1068,1124,1068,0,0,288,0,6120
1,1940,1717,901,1125,0,0,410,592,12400
2,1968,1978,832,1098,0,0,486,880,9900
2,1900,1428,712,848,264,1,576,580,6451
2,1984,1003,1003,1003,120,1,588,0,7937
2,1977,1285,660,1285,138,0,528,0,8197
1,1953,1008,1008,1008,0,1,240,0,8923
2,1974,1792,896,896,0,1,480,896,9000
1,1968,1160,1113,1160,81,1,257,0,17979
2,1954,988,988,988,0,1,520,0,21750
2,1996,2037,672,1302,100,0,472,735,10541
2,1972,1610,1124,1610,202,0,515,0,11358
2,2002,1444,1431,1444,144,1,577,0,10739
0,1961,1800,1800,1800,0,1,0,0,8513
3,1990,2196,2158,2196,84,0,701,0,14684
1,1945,747,747,747,0,1,220,0,4608
3,2005,1958,1026,1026,154,0,936,932,10625
2,1957,1478,1478,1478,114,0,442,0,8400
2,1939,1954,798,1137,0,0,431,817,15660
2,1984,889,864,889,0,1,484,0,12395
2,2005,1553,756,756,0,1,615,797,8125
2,1980,1556,716,716,161,0,452,840,1950
2,1976,1025,1015,1025,127,0,370,0,8660
2,1910,2019,728,1136,509,1,532,883,11414
2,1956,1074,894,1074,0,0,396,0,7450
2,1939,1118,793,793,0,0,410,325,7800
3,2000,2052,1107,1040,210,0,642,1012,10125
1,1956,928,928,928,261,1,252,0,13300
0,1925,1601,936,936,0,1,0,665,7288
3,2006,1574,1574,1574,144,0,824,0,11957
2,1969,1258,1198,1258,120,1,400,0,12900
3,1995,3627,1930,1831,361,0,807,1796,35760
2,1966,2087,832,976,133,1,444,1111,12205
2,2005,1270,1270,1270,0,1,524,0,7242
1,1920,1480,972,1044,0,1,207,0,5400
2,1967,1342,1372,1342,0,0,457,0,9790
2,1958,1344,819,1344,0,0,525,0,14375
3,2009,2334,1590,1627,144,0,751,707,12858
2,1952,1044,540,1044,0,1,504,0,8712
1,1931,1367,884,959,0,0,560,408,6240
1,1959,1040,1040,1040,0,1,286,0,7500
1,1916,1690,815,815,0,0,225,875,8850
1,1967,1052,1052,1052,0,0,668,0,11625
2,1975,1621,1621,1621,0,0,478,0,9373
2,1905,1912,482,1221,0,0,672,691,10800
2,2006,1301,1293,1301,216,0,572,0,7200
2,2003,1992,1053,1053,140,0,648,939,9375
3,2006,1746,698,698,0,0,350,1048,9729
2,1997,1604,926,926,0,0,470,678,8702
2,1935,3672,1836,1836,684,0,836,1836,19800
3,2007,2084,2078,2084,188,0,1220,0,14803
0,1912,2229,755,929,0,1,0,929,5520
1,1927,1666,1204,1204,0,1,384,462,5160
0,1946,3086,1598,1636,122,0,0,971,18030
2,1970,882,882,882,240,1,525,0,8400
0,1985,833,833,833,0,1,0,0,8780
2,1974,1494,1208,1494,296,0,461,0,15410
2,2006,1342,1342,1342,0,0,550,0,6240
3,2006,1718,1700,1718,216,0,786,0,12456
1,1930,713,713,713,0,1,371,0,10410
2,1960,1252,1602,1252,409,0,564,0,13500
2,1972,894,894,894,256,1,552,0,9800
3,2006,1802,1802,1802,158,0,843,0,13615
1,1948,972,972,972,0,0,240,0,8000
2,1993,2200,812,1101,168,0,453,1099,14171
2,2000,1690,915,940,0,0,442,750,9487
0,2007,1120,1120,1120,0,1,0,0,8402
2,1998,1924,1086,1086,208,0,592,838,12011
2,2006,1250,625,625,0,1,625,625,4017
1,1939,1132,608,608,0,1,240,524,6000
2,1998,1425,1425,1425,0,1,591,0,8685
2,2003,1948,847,847,0,0,434,1101,7875
2,1978,1441,855,855,28,0,440,586,2289
3,2007,2464,2418,2464,358,0,650,0,13693
1,1922,498,498,498,0,1,216,0,8088
2,1968,1040,1040,1040,188,1,686,0,7476
1,1953,1319,608,1319,66,1,270,0,10634
2,1976,2499,392,1487,0,0,527,1012,9600
3,1999,2599,1393,1422,668,0,779,1177,14774
1,1948,1079,570,617,135,0,249,462,5190
2,1960,1175,1175,1175,0,1,484,0,7635
1,1947,1531,756,1169,0,0,209,0,9350
2,1926,747,600,747,0,1,528,0,5825
1,1920,1245,1008,1060,0,1,315,185,8239
2,1968,1392,1392,1392,0,0,576,0,13560
0,2004,1158,1158,1158,0,1,0,0,7500
4,1993,1802,946,964,450,0,1017,838,12361
2,2005,1721,1721,1721,168,1,554,0,9254
2,1920,1128,698,698,30,1,528,430,7500
3,2006,1976,1976,1976,250,0,908,0,14977
2,2006,1220,1199,1220,105,1,632,0,7406
1,1955,768,768,768,0,0,355,0,8172
0,1910,968,600,600,0,1,0,368,5925
2,1976,1444,1444,1444,0,0,473,0,10400
2,2002,2031,1128,1128,0,0,577,903,9473
2,1949,1126,0,1126,0,1,520,0,8777
2,1923,832,678,832,0,0,780,0,9656
1,1900,720,448,448,0,1,280,272,7008
2,2007,1234,1234,1234,0,1,484,0,11049
2,1985,1298,1298,1298,165,0,403,0,11200
5,1925,1072,1072,1072,0,1,1184,0,8635
3,2005,2000,1910,2000,351,0,722,0,18261
3,2006,2589,1738,1738,0,0,831,851,16387
2,1972,768,768,768,58,1,396,0,8445
0,1912,1716,780,936,0,1,0,780,5687
2,1948,2320,0,1547,120,0,672,720,14762
3,2005,1922,1922,1922,178,0,676,0,14157
2,1964,1350,1248,1350,176,1,520,0,9020
3,2006,1588,1588,1588,144,0,825,0,10000
2,1963,1000,1000,1000,238,0,575,0,13050
2,1962,2486,1595,1611,0,0,576,875,33120
1,1961,888,920,888,0,1,240,0,8700
2,1961,1313,1313,1313,172,0,610,0,9350
2,1976,2898,1565,2898,0,0,665,0,15498
2,1953,1152,1152,1152,0,1,636,0,9373
0,1922,796,796,796,0,1,0,0,3636
2,2004,1269,1256,1269,146,0,430,0,3182
2,1961,988,988,988,0,1,572,0,9945
1,1937,1938,942,1265,0,0,240,673,11700
2,1980,2044,738,1277,28,0,489,767,10400
2,1999,1452,691,713,0,1,506,739,3768
2,1976,1370,1090,1370,0,0,479,0,10400
1,1953,1057,1057,1057,0,1,246,0,7922
1,1954,992,381,992,60,1,319,0,8842
1,1955,1150,1078,1150,0,1,288,0,9600
2,2004,1708,976,976,0,1,380,732,3363
2,2006,1550,1092,1112,0,1,438,438,8125
1,1900,1367,861,961,0,1,384,406,8405
1,1934,1660,715,849,0,0,240,811,11988
2,2003,1390,1390,1390,0,1,545,0,8810
2,2002,2169,1284,1284,192,0,647,885,9375
1,1948,1633,1027,1027,0,0,240,606,11851
1,1901,1173,592,933,0,1,240,240,5680
0,1916,1928,686,948,0,1,0,980,7082
2,2004,1414,1375,1414,144,0,398,0,3072
1,1925,1015,768,1015,0,1,450,0,6120
2,2006,1660,1660,1660,322,0,500,0,10182
1,1954,1278,854,854,0,1,240,424,7200
4,1953,2034,0,2034,483,1,1041,0,43500
1,1910,1049,356,671,0,1,195,378,5150
2,2004,1391,1391,1391,156,1,530,0,4282
2,2006,1604,1604,1604,123,0,660,0,8814
1,1910,1984,1242,1242,64,1,360,742,8094
2,2007,1358,1350,1358,192,0,484,0,7301
2,1938,1409,861,861,225,0,528,548,6240
2,1890,2495,1313,1313,0,0,342,1182,10800
1,1925,572,572,572,0,1,200,0,10200
2,1961,999,944,999,144,1,588,0,12122
3,1994,4316,2444,2444,382,0,832,1872,21535
3,1949,2002,1001,1001,0,1,871,1001,6270
2,2004,1158,1158,1158,0,1,576,0,13072
2,1955,1056,1056,1056,264,1,572,0,34650
1,1921,1107,629,727,0,1,625,380,9140
1,1924,1296,1107,1296,0,0,260,0,4853
1,1962,912,912,912,0,1,252,0,7150
2,1971,1587,1587,1587,0,0,525,0,10667
2,1987,1501,1501,1501,240,0,512,0,4054
2,1980,1032,516,516,279,0,452,516,1733
2,2007,1476,738,738,0,1,552,738,8145
1,1905,1376,738,714,0,1,216,662,7614
1,1915,1396,698,698,0,1,384,698,8730
2,2006,1432,1422,1432,297,0,492,0,9139
2,2005,1358,1358,1358,192,0,484,0,6904
2,1992,1482,384,812,100,0,392,670,9125
2,1964,1921,1921,1921,0,1,576,0,11136
2,1929,1517,792,792,0,0,400,725,11435
2,2007,1710,1710,1710,156,0,557,0,8118
2,2006,1492,738,738,0,1,440,754,10237
2,1966,1120,864,1120,0,0,656,0,10710
1,1956,1337,832,832,0,1,263,505,8382
1,1962,894,894,894,0,1,308,0,6600
2,2009,1508,1508,1508,0,0,572,0,17485
2,1960,1478,1478,1478,0,0,498,0,17600
2,1900,1416,780,940,0,1,400,476,9600
2,2006,1554,1554,1554,156,0,627,0,4590
3,2006,1531,1504,1531,184,0,700,0,10872
1,1940,672,672,672,0,1,256,0,4800
2,1978,1026,940,1026,0,1,576,0,10970
0,1905,1540,572,884,240,1,0,656,6000
2,1995,1995,930,950,275,0,610,1045,11250
0,1960,1556,1556,1556,0,1,0,0,8512
1,1973,988,462,526,0,0,297,462,1596
0,2007,1092,1092,1092,0,1,0,0,9278
1,1968,2142,896,1182,0,0,509,960,13000
2,1959,1472,0,1472,0,0,484,0,11650
2,2006,1496,654,664,100,0,426,832,17104
3,2006,2576,1234,1264,324,0,666,1312,12438
2,2008,5642,6110,4692,214,0,1418,950,63887
2,1976,1935,793,1142,0,0,550,793,12384
1,1959,1206,1206,1206,0,1,312,0,10725
1,1949,1382,0,1382,0,0,384,0,11800
2,1960,1429,1144,1429,216,0,572,0,14585
2,1978,1226,1226,1226,133,0,484,0,3876
2,1972,875,385,875,352,1,728,0,7200
3,2003,2668,1572,1572,400,0,726,1096,13688
2,1976,1117,1029,1117,144,0,672,0,7819
2,1957,1803,1134,1803,0,0,484,0,13125
2,1980,1036,1036,1036,133,0,484,0,3640
2,1999,1479,1468,1479,120,1,577,0,9382
2,1993,1879,1079,1079,400,0,473,800,10560
1,1971,874,864,874,0,1,352,0,6953
2,1960,2274,1105,1105,0,1,480,1169,11600
1,1972,780,780,780,196,1,352,0,7200
2,2000,1800,982,1007,100,0,463,793,8123
1,1939,1465,992,992,0,0,240,473,10164
2,1956,1898,1898,1898,0,0,484,0,26073
2,1977,2288,908,1316,321,0,520,972,13774
2,2003,1509,783,807,0,0,393,702,7875
3,2007,1600,1566,1600,0,0,890,0,14230
3,1993,3500,1733,1933,870,0,959,1567,17242
0,1922,864,864,864,0,1,0,0,4060
1,1956,968,0,968,0,1,331,0,8626
2,1979,1930,780,1085,192,0,481,845,11339
2,1976,2715,1142,1175,0,0,831,1540,8963
3,2004,2000,2000,2000,168,1,888,0,10386
1,1955,1098,1098,1098,0,1,260,0,7390
2,1996,1720,1720,1720,240,0,527,0,10593
1,1969,1096,1096,1096,240,1,299,0,15870
2,1978,1601,1271,1601,0,0,478,0,11880
2,2000,1892,982,1008,108,0,431,884,8220
2,1999,1790,873,882,0,1,588,908,9179
2,1900,2168,760,928,467,1,576,928,8660
2,1967,1829,1829,1829,0,1,535,0,10456
1,1955,1163,1162,1163,142,1,220,0,5820
2,2006,1342,1342,1342,0,0,550,0,6240
3,2003,2470,2535,2470,154,0,789,0,12720
2,2002,1861,916,920,146,1,492,941,13450
2,1997,1494,1479,1494,168,1,576,0,9236
3,2003,2283,1008,1008,120,0,632,1275,11792
0,1940,1306,728,1306,263,1,0,0,5350
4,2000,2787,1168,1168,312,0,820,1619,11855
2,2006,1550,1550,1550,0,1,528,0,5330
1,1954,1063,1056,1063,0,1,280,0,9920
1,1972,1302,630,630,185,1,264,672,1680
1,1920,864,592,432,0,1,216,432,9000
1,1964,1251,1251,1251,0,0,461,0,8800
2,1910,1436,676,760,147,1,528,676,8777
2,1965,1986,768,1186,0,0,486,800,13600
2,1999,1755,840,840,176,0,530,915,9468
1,1959,882,0,882,0,1,294,0,8339
1,1966,912,912,912,204,1,315,0,8169
3,2006,2828,1466,1466,125,0,1052,1362,9965
1,1920,1450,624,730,0,1,288,720,5350
2,2005,1536,768,768,100,0,400,768,10237
2,1999,2322,1037,1037,144,0,400,1285,12460
2,1967,1334,1334,1334,0,1,477,0,10140
2,1979,1625,1625,1625,136,0,576,0,23580
3,2006,2076,2076,2076,216,0,850,0,13891
2,1965,1073,1073,1073,0,1,515,0,10289
1,1940,919,600,600,0,1,231,319,6001
2,1991,1595,1582,1595,0,1,672,0,11070
1,1956,1073,1073,1073,0,1,340,0,9571
2,1995,2090,1220,1220,0,0,556,870,10000
2,1968,1295,1295,1295,0,1,528,0,11700
1,1954,1089,1089,1089,328,0,252,0,7440
0,1931,774,544,774,0,1,0,0,4270
2,1977,1069,1069,1069,0,0,440,0,4043
2,1978,1110,1097,1110,303,0,602,0,9101
0,1920,1452,736,736,0,1,0,716,4456
2,1958,1560,1560,1560,0,1,484,0,8078
3,2006,1258,1258,1258,144,0,648,0,3922
2,1996,1636,916,916,168,0,386,720,15038
2,1999,1983,978,1005,0,0,490,978,10762
2,1948,1325,409,1325,0,0,576,0,17541
2,1997,1525,813,813,421,0,400,712,8238
0,1930,1200,780,780,0,1,0,420,8155
2,1960,1560,1560,1560,0,0,580,0,25485
0,1994,990,990,990,0,1,0,0,8070
0,1872,2358,684,938,0,1,0,1215,5250
0,1971,858,858,858,0,1,0,0,8125
2,2006,1456,728,728,0,0,440,728,11103
1,1955,1056,1056,1056,0,1,300,0,13600
2,2004,1548,1365,1548,143,0,388,0,3072
3,2003,2046,998,1006,320,0,871,1040,10625
2,1971,864,864,864,216,1,576,0,10500
2,2004,1646,1594,1646,128,0,482,0,3842
1,1957,1236,1070,1236,0,0,447,0,10011
2,1978,2050,832,1154,192,0,529,896,13250
2,2001,1789,858,872,0,0,546,917,10646
2,2006,1294,1286,1294,168,0,662,0,6762
2,2003,1114,1114,1114,0,1,576,0,13695
2,1979,1586,1362,1586,192,0,435,0,17043
2,2007,1232,1232,1232,132,1,632,0,7314
1,1962,999,925,999,150,1,300,0,10205
2,1972,864,864,864,155,1,576,0,7200
3,2006,2945,1410,1426,192,0,641,1519,13682
2,1991,2417,1288,1301,127,0,462,1116,16059
3,2006,2640,2036,2036,0,0,792,604,13162
2,2005,1964,1100,1116,200,0,760,848,12447
1,1915,1605,840,840,0,1,379,765,5790
1,1920,1077,961,1077,0,1,338,0,8967
1,1959,1150,1150,1150,0,1,300,0,7945
1,1948,936,624,624,0,1,265,312,6956
2,2007,1340,1340,1340,100,1,396,0,8899
2,1926,1316,750,960,0,1,576,356,8550
1,1968,898,833,898,143,1,326,0,8400
2,2005,1490,745,745,36,0,392,745,8918
1,1921,1073,1073,1073,0,1,326,0,5400
0,1915,1526,1013,1013,0,1,0,0,8470
2,2005,1456,728,728,0,0,390,728,10237
2,1920,985,576,985,0,1,676,0,7898
2,1976,1044,960,1044,228,0,528,0,6285
3,2007,1702,1702,1702,0,0,844,0,10130
2,1998,2452,1028,1210,208,0,683,1242,16226
2,1971,1670,825,845,0,1,464,825,13355
2,1998,1204,1204,1204,0,1,412,0,4500
1,1954,984,936,984,0,1,280,0,6390
1,1942,976,976,976,160,1,215,0,7288
2,1978,1034,450,1034,311,0,504,0,7703
2,2004,1709,970,970,0,1,380,739,2522
3,2000,2172,1519,1533,162,0,687,639,11000
2,1962,1057,1057,1057,0,1,576,0,7420
2,2006,1370,1370,1370,120,0,484,0,6442
2,1990,2329,1475,1532,192,0,514,797,11839
1,1960,1100,1100,1100,355,0,312,0,12493
2,2003,1668,840,840,144,1,500,828,11317
2,1991,1294,1278,1294,112,1,496,0,7153
2,1962,1283,931,1283,0,1,506,0,7763
2,2001,1788,1753,1788,202,0,522,0,11838
2,1968,1044,912,1044,200,0,372,0,10180
1,1959,1041,1041,1041,224,1,270,0,9600
2,1978,1981,1117,1117,336,0,522,864,17082
1,1959,864,864,864,0,1,300,0,9100
1,2008,1133,192,1133,0,1,308,0,9836
1,1950,1521,910,910,199,1,597,611,12144
2,2000,1848,975,975,280,0,592,873,7379
2,2007,1358,1350,1358,192,0,484,0,10307
1,1924,1691,1026,1026,0,0,308,665,5000
2,2005,1166,856,1166,212,1,400,0,9587
3,2003,1792,1792,1792,206,0,874,0,11846
1,1962,912,912,912,140,1,352,0,12968
2,1998,1796,794,882,0,1,546,914,9531
1,1967,980,980,980,68,1,384,0,9750
2,2000,2054,992,1022,24,0,390,1032,12224
1,1957,845,0,845,186,1,290,0,11500
2,1988,2062,1157,1180,60,0,454,882,14364
1,1958,1601,533,1021,280,1,300,580,13825
2,1927,756,660,756,80,1,440,0,9259
2,1970,864,864,864,210,1,576,0,7038
2,1957,1236,912,1236,0,1,923,0,7407
2,1999,1675,1666,1675,165,1,435,0,7915
0,1978,1040,1040,1040,0,1,0,0,8430
1,1920,967,967,967,0,0,180,0,3153
3,2008,2007,1017,1026,168,0,812,981,11003
2,2004,1143,1143,1143,0,0,588,0,3628
1,1958,1142,160,1142,0,0,384,0,9000
3,1918,2624,1370,1370,0,0,864,1254,22420
1,1920,1192,596,596,0,1,189,596,6402
2,1986,1453,1453,1453,0,0,445,0,5271
2,1999,1764,850,886,120,0,560,878,11690
2,1954,1906,1310,1906,0,0,576,0,17500
2,1898,2138,849,1075,40,1,360,1063,8100
1,1978,864,864,864,0,1,336,0,7000
1,1950,841,721,841,250,1,294,0,8400
2,1967,2640,932,1271,0,0,515,1369,10400
2,1956,1437,1188,1437,304,0,576,0,14175
2,1996,2125,1064,1064,168,0,576,1061,10990
1,1959,1143,1143,1143,0,1,308,0,8050
1,1958,808,808,808,143,1,308,0,5175
2,1963,816,816,816,106,1,516,0,8472
2,1930,1573,1078,1128,0,0,360,445,6240
0,1890,1544,925,1000,231,1,0,544,14190
1,1922,1022,1022,1022,0,0,184,0,4480
2,1992,1731,836,844,307,1,462,887,9370
2,1955,1360,384,1360,0,0,572,0,7134
2,2005,1190,1169,1190,100,1,578,0,8769
1,1969,1176,1176,1176,0,1,360,0,16133
2,2000,1690,924,948,100,0,463,742,8063
3,1994,2063,2024,2063,182,0,815,0,10750
2,1970,1422,925,1422,252,1,576,0,9457
3,2005,1546,1546,1546,144,1,796,0,11750
1,1973,945,945,945,174,0,253,0,2394
2,1996,1716,880,909,0,0,512,807,8750
2,2005,1306,1306,1306,170,0,624,0,5381
2,1992,1593,808,808,342,0,389,785,9636
2,1969,1427,1427,1427,0,1,516,0,11104
2,1890,2268,346,1157,0,1,624,1111,9000
4,1993,1440,1344,1440,288,1,920,0,9069
2,2000,1889,982,1008,0,0,431,881,8658
2,2002,1419,408,779,120,0,527,640,7750
2,2005,1072,547,1072,0,1,525,0,3675
2,1991,1472,384,802,164,0,402,670,10784
2,2007,1869,1869,1869,210,0,617,0,7820
2,1970,864,864,864,0,1,463,0,8120
2,1885,2290,777,1246,0,1,560,1044,11340
2,1980,1229,561,561,154,0,462,668,1612
1,1930,816,816,816,0,1,432,0,5890
2,1976,1671,1426,1671,280,0,550,0,16280
2,1993,1199,1199,1199,0,1,530,0,7892
2,1924,1301,1145,1301,0,1,440,0,6911
2,1961,1453,1453,1453,0,0,530,0,10573
3,1957,1797,1617,1797,0,0,963,0,11765
0,1954,1124,0,1124,0,0,0,0,8335
2,1965,1214,1214,1214,0,1,461,0,9170
1,1946,704,560,704,0,1,220,0,4280
3,2006,1977,982,982,240,1,574,995,9605
2,2000,1349,1349,1349,120,1,539,0,8450
1,1915,1456,728,728,0,1,308,728,6000
2,2006,1335,1335,1335,0,1,575,0,9000
3,2006,1828,1298,1298,0,1,876,530,10732
3,2007,2290,2320,2290,192,0,1174,0,17169
2,1966,1093,1093,1093,224,0,484,0,10738
2,1929,1344,672,672,0,0,456,672,5700
0,1971,796,796,796,129,1,0,0,6723
2,1971,1078,1078,1078,0,0,500,0,12537
2,1975,1558,864,1558,140,1,440,0,14330
1,1946,1242,484,1242,0,1,336,0,17808
2,1972,1790,732,1012,148,0,484,778,10400
2,1997,1604,926,926,0,0,470,678,10839
2,1967,1620,1620,1620,0,0,578,0,15387
3,2004,1780,1780,1780,144,0,816,0,14828
2,1975,1193,1176,1193,40,0,506,0,11050
2,2005,1408,734,734,0,1,489,674,7023
0,1945,866,686,866,58,1,0,0,3880
3,2005,2028,1868,2028,326,0,880,0,11443
1,1968,952,952,952,0,1,288,0,8300
2,1915,2180,1138,1138,0,0,720,1042,10320
1,1956,1104,1104,1104,0,1,384,0,10425
2,1920,1362,611,751,0,1,502,611,6155
2,1936,1135,560,575,256,1,576,560,7200
2,2007,2610,1184,1184,208,0,550,1426,9000
1,1930,1098,531,567,0,0,216,531,4000
2,1958,1650,1632,1650,0,0,518,0,50102
2,2003,1557,1374,1557,143,0,420,0,3196
2,1920,1118,648,734,0,1,440,384,4400
2,1948,1122,924,1122,0,1,528,0,12000
2,1963,1395,1395,1395,657,0,440,0,9760
3,1995,2726,1342,1358,307,0,725,1368,10019
1,1926,919,894,919,0,1,195,0,7000
3,2003,2452,2452,2452,0,0,886,0,15274
2,2003,1405,1405,1405,148,0,478,0,3136
1,1957,1244,1244,1244,0,0,336,0,11988
3,2004,2373,1052,1052,120,0,632,1321,11631
2,2006,1492,738,738,100,1,440,754,9073
2,1930,768,768,768,0,1,440,0,6291
2,1997,1786,824,905,0,1,684,881,9337
1,1924,1310,617,865,0,1,398,445,7000
2,2009,1224,612,612,0,1,528,612,3000
2,1953,910,105,910,196,1,414,0,8892
3,2004,2468,1136,1136,184,0,872,1332,12099
2,1954,1363,1385,1363,81,0,439,0,39104
2,1995,1616,1595,1616,237,0,608,0,5389
2,1994,1850,973,979,168,0,467,871,29959
2,1937,1176,698,786,210,1,624,390,6000
1,1956,1509,1509,1509,158,0,322,0,9571
1,1996,1097,1097,1097,306,1,242,0,16561
2,2005,1208,1208,1208,105,1,632,0,7488
2,1978,2784,1392,1392,0,0,564,1392,16692
1,1936,879,830,879,0,1,180,0,5220
2,1992,2295,1095,1166,0,0,590,1129,13346
2,1923,1848,833,1053,0,0,370,795,13053
2,1990,2514,1216,1298,0,1,693,1216,11170
1,1967,1656,624,1092,0,0,288,564,6000
2,1986,1400,676,698,0,1,465,702,10274
2,1999,1651,831,873,0,0,450,778,8390
1,1930,1324,741,741,0,1,180,583,6120
2,2007,1761,874,874,144,1,578,887,10207
2,1973,1656,1656,1656,0,1,506,0,9246
2,1981,1422,1422,1422,276,0,576,0,12090
2,2006,1625,1573,1625,123,0,495,0,5568
0,1971,864,864,864,0,0,0,0,10500
1,1940,1090,720,760,0,1,240,330,6000
3,2005,2206,1090,1117,148,0,670,1089,13975
2,2006,1442,352,712,100,1,400,730,9802
3,2005,2097,2077,2097,192,0,1134,0,20896
0,1910,1447,801,801,80,1,0,646,10134
2,1988,1412,1392,1412,0,0,576,0,11457
1,1984,923,876,923,362,1,264,0,6951
3,2003,2385,1317,1217,192,0,818,1168,14277
1,1982,845,845,845,0,1,264,0,6600
1,1910,1330,396,665,0,1,390,665,7518
1,1935,1573,884,989,0,1,240,584,6120
3,2007,1726,1726,1726,171,0,786,0,9416
2,2008,1256,1145,1256,0,0,641,0,4217
2,2003,1553,1553,1553,192,1,588,0,8736
3,2002,1712,1712,1712,218,0,701,0,16770
2,1939,2009,989,1245,0,0,400,764,6240
2,1912,759,451,759,40,1,576,0,10320
3,1996,2398,1379,1383,239,0,834,1015,11787
2,2003,1656,746,760,178,0,397,896,6931
1,1921,1298,651,759,216,0,240,539,6821
3,2002,1922,1922,1922,201,0,692,0,11305
2,1998,1724,880,880,120,1,527,844,8924
1,1900,1290,554,736,38,1,200,554,5870
1,1913,694,440,694,0,0,352,0,4280
1,1945,1487,735,798,0,0,220,689,8741
2,1997,1384,384,754,0,0,390,630,8872
2,1976,1324,1228,1324,407,0,585,0,8991
2,1975,1875,675,1109,48,0,485,766,10530
2,1954,1482,954,1482,0,0,609,0,16012
2,1964,2154,845,845,0,0,539,1309,8800
3,1999,1852,1004,1004,224,0,660,848,9066
2,1976,1523,1193,1523,0,0,478,0,11361
1,1920,1012,816,1012,121,1,429,0,9800
1,1956,1560,1150,1560,0,0,313,0,11767
1,1958,988,988,988,0,1,264,0,13587
1,1925,1060,756,916,0,0,308,144,6854
3,2005,1960,1728,1960,172,0,714,0,13618
0,1949,1192,720,720,0,1,0,472,10800
1,1951,884,884,884,0,1,270,0,15428
1,1930,1358,687,687,0,0,336,671,3600
2,1970,1657,1657,1657,0,0,484,0,12155
2,2002,2290,1128,1149,0,0,779,1141,11250
3,2008,2042,2042,2042,0,0,1390,0,12704
1,1965,965,828,965,421,1,300,0,7800
2,2006,1564,1546,1564,132,0,502,0,8298
2,2005,2064,1074,1074,0,0,527,990,13128
2,1925,764,680,764,0,1,504,0,5232
2,2001,1792,963,963,0,0,564,829,12435
1,1925,816,816,816,168,1,210,0,11672
3,2009,1968,774,774,0,0,680,1194,12003
3,2008,2402,3094,2402,0,0,672,0,15431
1,1950,932,932,932,0,0,306,0,8280
2,1960,1065,1065,1065,74,1,461,0,8892
1,1984,752,744,752,353,1,264,0,7175
2,1993,2075,1148,1091,235,0,473,984,10530
3,2004,1782,1782,1782,99,0,932,0,16870
2,1974,1026,970,1026,193,0,528,0,8410
1,1942,1282,672,778,0,1,240,504,4484
1,1950,1668,856,1112,0,1,271,556,9600
2,1994,1626,1602,1626,424,0,534,0,9938
2,2007,1419,1419,1419,140,0,567,0,8089
2,2005,1596,784,784,144,1,610,812,9316
1,1952,1008,1008,1008,0,1,280,0,12778
2,1917,2058,735,1134,0,0,396,924,9600
2,2006,1412,616,616,0,0,432,796,8499
1,1953,1036,1036,1036,120,1,312,0,7584
1,1935,1032,0,1032,0,0,260,0,8250
2,1970,864,864,864,96,1,660,0,6960
2,1998,1604,926,926,360,0,470,678,9978
1,1963,1380,1380,1380,0,1,364,0,10143
2,1963,925,925,925,203,1,484,0,8638
1,1937,906,348,453,0,1,231,453,4882
3,1997,1838,1838,1838,160,1,721,0,10126
2,1998,1337,1237,1337,0,1,405,0,4500
3,1915,1214,672,694,216,1,936,520,10410
2,1975,969,969,969,0,1,440,0,10356
3,2008,2296,1722,1728,382,0,842,568,13478
2,1999,1458,729,729,0,0,440,729,3230
2,1999,1337,1405,1337,203,0,511,0,5858
1,1979,918,918,918,28,0,264,0,7892
2,1974,1389,1389,1389,240,0,418,0,10010
1,1926,1224,818,818,0,1,210,406,3950
2,1948,1559,1559,1559,0,1,812,0,8100
1,1960,1144,1144,1144,0,0,336,0,9100
2,2001,1338,1338,1338,0,1,582,0,4920
3,2007,2656,1934,1943,268,0,1040,713,13641
1,1919,1636,818,818,0,0,288,818,9399
2,1974,1877,1084,1084,0,0,488,793,8000
2,1966,1320,1164,1320,160,0,564,0,11777
2,1992,1603,761,810,0,1,484,793,7153
2,1890,1869,1088,1188,48,1,456,561,8820
2,1940,1215,720,720,0,1,720,495,7000
0,1970,1092,546,546,200,1,0,546,1476
3,2006,2643,2153,2069,414,0,694,574,13693
0,1935,729,270,729,0,1,0,0,4130
1,1951,1091,1091,1091,66,0,344,0,7801
2,1996,2013,1117,1127,180,0,455,886,9920
1,1977,1268,1268,1268,173,1,252,0,9286
1,1955,972,972,972,0,1,305,0,10895
2,1950,1067,1067,1067,290,1,436,0,9600
2,1952,733,0,733,0,1,487,0,14584
2,2005,1752,1752,1752,196,0,576,0,7658
2,2004,1710,1710,1710,100,0,550,0,12118
2,1999,1430,384,774,0,0,410,656,7848
2,1992,883,828,883,100,0,698,0,7669
2,1961,1155,1109,1155,192,1,576,0,11782
3,2006,1656,1656,1656,0,1,826,0,11096
2,1977,1279,1196,1279,238,0,473,0,10125
1,1939,1342,739,874,0,0,240,468,6000
1,1940,1302,680,798,0,0,224,504,6960
2,1972,1181,1138,1181,0,1,588,0,10012
2,2005,1367,1367,1367,0,0,484,0,12304
2,1964,1582,1624,1582,168,1,390,0,36500
2,2004,1709,970,970,0,1,380,739,2522
1,1941,1288,824,824,0,1,240,464,6191
2,2001,1665,810,810,0,1,528,855,8400
3,2007,1689,1689,1689,0,1,954,0,9849
1,1940,1750,983,983,245,1,423,767,12508
1,1963,864,864,864,0,1,276,0,6360
2,2006,1330,1330,1330,0,0,437,0,8334
2,2002,1725,840,840,0,1,550,885,8749
2,1993,1744,996,1014,370,1,457,730,9453
1,1925,1236,768,788,0,0,384,448,7006
1,1920,835,458,835,0,1,366,0,10625
2,2004,1646,1594,1646,128,0,525,0,3842
1,1920,1317,649,649,0,1,250,668,8500
2,1975,1533,1533,1533,200,0,576,0,70761
2,1981,1226,1226,1226,133,0,484,0,3782
2,2006,1326,1326,1326,100,1,427,0,11660
0,1920,1198,901,1088,0,1,0,110,5586
2,2006,1460,1460,1460,0,0,480,0,10037
2,2005,1223,600,520,0,1,480,623,2544
1,1922,1180,700,1180,0,0,252,0,11600
2,1995,2061,1070,1094,296,0,647,967,9085
2,2000,1671,959,959,0,0,472,712,10852
1,1972,987,483,483,0,0,288,504,1680
2,1997,1608,945,945,252,0,470,663,10179
2,2005,1536,768,768,0,1,400,768,9045
2,2002,1358,1348,1358,68,0,418,0,11088
2,1993,1775,740,1006,234,0,425,769,9317
2,1957,1073,1073,1073,0,1,720,0,6565
3,1946,1499,904,904,0,0,869,595,9000
2,2001,1337,1337,1337,136,0,511,0,4113
1,1956,1375,1240,1375,0,0,323,0,14175
2,1997,1511,802,802,95,0,413,709,11207
3,2010,1418,1642,1418,160,0,852,0,12853
1,1962,1207,1135,1207,0,1,264,0,9510
3,2007,1555,1373,1555,143,0,660,0,3684
2,1945,998,0,998,0,1,460,0,9000
2,2005,1561,1561,1561,203,0,556,0,7313
2,1923,1576,1324,1072,0,0,528,504,21384
0,1922,2128,1040,1088,0,1,0,1040,3000
2,1965,2140,744,825,0,0,549,1315,8970
2,1960,1224,1224,1224,474,0,576,0,20000
3,2005,2490,2458,2490,70,0,795,0,11128
3,1998,2475,1629,1645,23,0,962,830,17433
2,1958,864,864,864,0,1,624,0,9100
2,1980,1686,1686,1686,384,0,612,0,10240
2,2002,1720,840,840,138,0,400,880,8010
2,2005,1362,1362,1362,192,0,460,0,6289
2,1961,1773,1313,1773,355,0,418,0,10800
2,1994,2687,2062,2079,168,1,618,608,13108
2,1980,1056,1056,1056,264,1,576,0,6979
2,2005,1132,1132,1132,252,1,451,0,7024
1,1972,1092,546,546,0,1,253,546,1484
3,2003,1589,1406,1589,143,0,630,0,3621
2,1964,1440,720,720,0,0,480,720,9350
2,1910,1232,616,616,280,1,480,616,4571
2,2004,1515,789,813,0,0,393,702,9024
1,1925,1472,702,842,0,1,250,630,9600
2,1980,2362,2002,2362,180,0,546,0,12000
2,2004,2466,1580,1580,159,0,610,886,11143
0,1920,1701,600,1101,0,1,0,600,7627
3,2000,2198,1145,1145,192,0,836,1053,14260
2,1997,1682,1664,1682,0,0,528,0,6264
2,1964,1486,1486,1486,0,1,480,0,9937
2,2000,1874,1058,1058,0,0,588,816,7500
2,1974,1322,855,855,260,0,440,467,2308
2,1978,1040,960,1040,131,0,616,0,7176
3,2004,1512,1512,1512,210,1,845,0,10141
1,1900,1844,709,1157,84,0,240,687,4800
1,1948,1458,912,912,192,0,330,546,17503
2,1879,2454,819,1312,0,0,576,1142,13500
3,2003,1455,1415,1455,156,0,644,0,3940
2,1921,2601,612,990,183,1,621,1611,9842
2,1966,2157,924,1216,105,0,487,941,14200
3,1998,2582,1389,1411,286,0,758,1171,11002
2,1992,1187,1168,1187,0,1,420,0,9556
2,1992,1287,624,624,150,1,440,663,10429
3,1880,3493,1470,1675,302,0,870,1818,18386
2,1977,1008,923,1008,201,0,678,0,9129
1,1950,1558,910,910,289,1,282,648,13710
1,1959,876,876,876,0,1,320,0,6410
1,1920,1802,793,901,0,0,216,901,7588
1,1942,1453,835,955,0,0,240,498,6360
2,1915,1338,832,846,0,1,528,492,7822
2,2004,1488,1488,1488,168,0,506,0,4835
1,1954,825,825,825,0,1,350,0,7200
3,2005,1616,1616,1616,208,1,834,0,8688
2,2006,1352,1352,1352,0,0,466,0,3606
2,2005,1072,547,1072,0,1,525,0,3675
2,2003,1080,530,530,0,1,496,550,4447
1,1924,872,872,872,0,0,322,0,17529
2,1980,788,728,788,133,0,484,0,4420
2,1999,1341,1341,1341,240,0,482,0,17227
0,1923,1828,859,942,174,1,0,886,9060
2,2000,1823,928,928,192,1,626,895,12192
2,1961,964,964,964,170,0,784,0,8243
1,1971,858,858,858,0,1,684,0,7340
2,2005,1364,1364,1364,192,0,484,0,7052
2,2004,1598,848,848,100,0,433,750,9171
2,2006,1797,939,939,144,1,639,858,9245
0,1902,1864,1020,978,0,1,0,886,5852
1,2004,1073,1073,1073,0,1,246,0,5500
2,1968,1770,900,884,0,1,530,886,8640
0,1947,912,0,672,0,1,0,240,6240
2,2005,1326,1326,1326,120,1,388,0,12216
2,1970,960,960,960,0,1,576,0,9873
2,1920,1376,768,752,0,1,576,624,8850
3,2009,1226,1226,1226,0,1,740,0,10402
2,1995,1734,1587,1734,52,1,528,0,8013
0,1965,1664,0,1664,0,1,0,0,9825
2,1980,1045,516,529,180,0,462,516,1782
1,1948,1224,816,816,414,1,280,408,8064
3,1994,2494,1290,1305,200,0,803,1189,10236
2,1969,988,938,988,0,0,540,0,21453
2,1990,1217,1188,1217,168,1,497,0,9947
3,2005,1838,1838,1838,161,0,682,0,11577
2,1922,1470,738,868,0,1,624,602,10560
1,1969,1479,864,864,287,1,275,615,10544
2,1955,864,864,864,196,1,528,0,8172
2,2004,1582,770,770,0,1,520,812,8320
2,1997,1692,878,892,0,0,513,800,9337
2,1936,1040,528,548,306,1,624,492,6240
1,1959,1440,1248,1440,150,1,480,0,9840
2,2008,1506,1498,1506,0,0,592,0,14587
1,1957,1306,992,1306,0,1,756,0,8712
2,1925,1281,1151,845,0,1,580,436,10284
1,1928,1576,1042,1042,0,0,225,534,6240
3,2004,2452,1117,1132,113,0,691,1320,13418
2,1967,1296,0,1296,0,1,516,0,10791
3,2005,2376,1158,1158,240,0,853,1218,14215
2,2002,1811,972,972,225,0,565,839,8470
1,1973,988,526,526,120,1,297,462,1974
3,1990,3222,1673,1699,367,0,594,1523,12376
2,1941,1604,984,984,0,1,660,620,10998
3,2005,1590,1570,1590,176,1,754,0,11645
1,1973,987,483,483,52,1,264,504,1680
1,1973,1092,546,546,120,1,286,546,1974
2,2002,1573,1573,1573,0,1,544,0,9808
1,1947,1054,1046,1054,0,1,240,0,9488
3,1998,1976,1044,1079,210,0,885,897,9660
2,1973,1242,1242,1242,0,0,528,0,9600
2,1979,1229,1094,1229,120,0,672,0,7040
0,1971,1824,912,912,128,1,0,912,9400
0,1956,882,882,882,0,1,0,0,5500
2,2003,1733,847,847,100,0,433,886,12394
2,1900,1699,978,1014,0,1,420,685,10615
0,1907,1884,707,942,0,1,0,942,6449
2,2001,1312,1267,1312,256,1,471,0,6718
2,1954,1375,1367,1375,0,0,451,0,11310
2,2009,1502,1502,1502,0,1,644,0,9541
3,2008,2234,2216,2234,0,0,1166,0,17423
1,1952,732,732,732,0,1,240,0,7200
2,2004,1200,600,600,0,1,480,600,2544
3,2008,1720,1720,1720,208,0,846,0,10816
2,1988,1509,1461,1509,224,0,600,0,10200
1,1976,1112,536,536,182,1,336,576,2592
2,1930,1801,697,1104,0,0,365,697,14210
3,1910,1521,741,780,0,1,640,741,9720
2,1954,1299,967,1299,81,0,494,0,11375
3,2002,1611,1569,1611,262,1,1231,0,11664
0,2005,1131,1131,1131,0,1,0,0,13072
2,2004,1680,840,840,0,1,588,840,3515
2,1981,1440,1440,1440,0,0,467,0,12546
2,1930,1920,960,960,248,0,480,960,7804
1,1954,1008,1008,1008,0,0,275,0,11425
2,2005,1585,784,831,100,1,449,754,7632
2,1977,1734,0,1302,0,1,539,432,10125
3,1976,1034,1012,1034,0,1,888,0,12328
2,1996,965,870,965,71,1,580,0,11105
2,1975,1456,855,855,173,0,440,601,2280
2,1957,1392,1392,1392,0,0,528,0,11341
0,1923,869,440,869,0,1,0,0,5900
3,2002,2004,870,878,0,0,644,1126,12891
2,1965,1625,1625,1625,0,1,484,0,9750
2,2000,1652,782,782,0,1,532,870,8998
2,1960,1179,1179,1179,0,1,622,0,8240
1,1918,838,816,838,0,1,275,0,10267
2,1994,1908,915,933,144,0,493,975,8750
1,1958,1276,1276,1276,0,1,350,0,9571
2,1999,1358,1339,1358,176,1,625,0,7321
2,1992,1737,836,844,192,1,506,893,8285
1,1962,1188,1188,1188,261,1,312,0,26142
2,1990,2503,1223,1271,0,0,564,1232,19522
2,1993,1820,864,920,144,1,492,900,11613
2,2002,1419,1487,1419,196,1,543,0,8773
2,1972,864,864,864,216,1,576,0,12735
2,2001,1492,1492,1492,0,0,608,0,11166
2,2007,1258,1246,1258,0,1,462,0,7697
2,2009,1218,1218,1218,0,1,676,0,9215
2,1960,1496,1296,1496,0,1,450,0,9600
2,2006,1495,738,738,100,0,440,757,8857
2,1969,2112,952,1092,280,0,576,1020,11075
3,2007,1580,1580,1580,0,1,830,0,11932
2,1965,912,912,912,0,1,576,0,8872
2,1979,1353,1259,1353,240,0,478,0,10400
1,1920,1510,755,755,0,1,216,755,4899
1,1925,1348,884,884,0,0,216,464,6000
3,1900,1774,1095,1095,0,1,779,679,9600
3,2007,1582,1582,1582,209,1,905,0,12704
2,1997,1337,1405,1337,0,0,522,0,10943
2,2007,1428,1428,1428,0,1,480,0,11639
1,1948,1082,1082,1082,0,0,240,0,11664
2,1956,1145,301,1145,0,1,684,0,7700
2,1968,1920,570,1222,0,0,487,698,10192
2,1958,1604,1604,1604,42,1,576,0,8267
1,1931,875,715,875,48,1,180,0,6120
2,1983,1080,1084,1080,120,1,484,0,9187
1,1954,1626,988,988,366,1,332,638,10512
2,1976,1178,1090,1178,0,1,502,0,11000
2,2003,2149,1434,1518,168,0,670,631,12822
1,1950,1164,1164,1164,0,1,240,0,10880
3,2003,2262,1482,1482,168,0,749,780,12244
2,1994,1481,702,702,0,0,343,779,8125
1,1971,1109,372,576,35,1,288,533,10500
2,1963,1054,936,1054,120,1,480,0,8800
2,1922,2555,588,1423,431,0,672,748,11526
1,1949,1268,832,1036,0,0,288,0,12144
1,1924,792,768,792,316,1,240,0,9022
2,2006,1125,1125,1125,80,1,430,0,8536
2,1964,1851,822,1020,239,0,440,831,9760
2,1900,2337,662,1422,0,1,560,915,13600
2,1990,1321,1312,1321,0,0,484,0,5118
2,1918,1674,1163,1163,72,0,396,511,21780
2,1973,1055,1044,1055,455,0,542,0,12712
2,2003,1560,1560,1560,100,1,573,0,9196
3,1958,1776,1584,1776,0,1,888,0,11475
1,1921,1343,731,820,192,0,186,523,7681
3,2006,1606,1598,1606,230,0,871,0,9658
3,1996,2032,1840,2032,0,1,786,0,23730
2,2004,848,848,848,140,0,420,0,4435
4,1922,1436,892,1254,0,0,1488,182,10836
2,1977,1694,1694,1694,501,0,642,0,14694
2,1992,3228,3200,3228,264,0,546,0,12692
2,1940,861,861,861,158,1,539,0,12342
2,2005,1504,1346,1504,156,0,457,0,3182
2,2007,1372,1372,1372,0,1,529,0,8640
2,1977,2020,0,2020,0,0,630,0,8400
2,1971,1258,1258,1258,55,1,528,0,11040
2,2001,1872,1299,1299,160,0,531,573,11885
1,1972,1218,672,672,0,1,264,546,1680
2,1983,902,864,902,164,1,484,0,8885
3,1990,2243,700,1122,127,0,746,1121,13474
2,2002,1492,1492,1492,277,0,596,0,8000
2,1978,1664,1664,1664,0,1,616,0,8385
1,1980,923,923,923,80,0,264,0,8012
3,1993,2646,1347,1372,340,0,656,1274,9900
2,1989,1337,1337,1337,0,0,462,0,5950
0,1890,1080,684,684,0,1,0,396,5914
2,1998,1779,866,866,198,1,546,913,10400
2,1973,2521,942,1291,728,0,576,1230,3964
1,1959,1053,1053,1053,0,1,312,0,10007
1,1950,1435,910,910,0,1,308,525,8674
2,1974,1037,1037,1037,136,1,431,0,10751
1,1964,1302,1302,1302,333,1,309,0,9350
2,1967,1691,1680,1691,0,1,550,0,9900
1,1929,1158,862,950,0,0,208,208,6000
0,1900,1294,0,694,220,1,0,600,10800
3,2006,1717,1709,1717,169,0,908,0,11146
3,2004,1914,1420,1426,168,0,746,488,13215
1,1930,935,742,779,0,1,308,0,9100
1,1926,2080,1276,1276,0,0,282,804,10918
2,2007,1728,1884,1728,0,0,520,0,11449
3,2005,2798,1398,1414,182,0,670,1384,16023
2,1977,1426,690,698,252,1,440,728,7950
2,1999,1501,1490,1501,144,1,577,0,10335
2,1992,2872,1683,2129,0,0,541,743,10678
1,1957,1340,0,1340,116,0,252,0,9060
3,2000,2234,1160,1205,0,0,768,1029,9545
2,1970,1002,1002,1002,0,1,902,0,8750
2,1977,1411,1386,1411,192,0,544,0,11900
2,1992,1923,750,1061,240,0,564,862,10186
1,1956,1050,1050,1050,0,1,338,0,9600
2,2004,1630,868,868,120,0,436,762,7984
3,2008,1612,796,796,0,1,666,816,12018
1,1962,1027,1027,1027,0,1,299,0,8000
2,2001,1212,1212,1212,356,1,573,0,9100
0,1910,1347,1117,820,85,1,0,527,7000
3,2007,1651,1643,1651,192,0,870,0,10235
3,1969,2544,1248,1248,0,1,907,1296,9671
1,1968,1056,1056,1056,0,0,304,0,8450
3,1998,1916,1049,1036,0,0,741,880,11050
2,1952,1960,960,960,0,1,400,1000,7596
1,1977,985,985,985,210,1,328,0,8385
1,1940,1134,756,756,0,1,240,378,8160
2,1998,1494,1482,1494,402,0,514,0,16196
2,1932,2345,952,1170,0,0,360,1175,16560
1,1968,1159,1051,1159,466,0,336,0,11553
2,2004,1119,835,1119,100,1,437,0,16219
1,1973,1218,672,672,0,1,264,546,2058
1,1938,1610,972,1052,0,0,480,558,18600
2,2006,1565,1511,1565,0,1,476,0,3784
3,2003,1575,1603,1575,216,0,732,0,10845
1,1954,1387,811,811,0,1,256,576,6000
2,2005,1247,1247,1247,0,0,550,0,3316
1,1925,641,641,641,184,1,272,0,7030
2,1992,1915,908,927,120,0,506,988,10041
1,1972,948,483,483,0,1,264,465,1680
3,2006,2121,2121,2121,124,0,732,0,14450
2,1999,2299,938,957,188,0,482,1342,7500
2,1998,1382,384,751,256,0,396,631,8923
1,1966,1040,1040,1040,0,1,264,0,11677
2,1914,1768,880,880,0,0,320,888,10800
1,1940,1034,735,735,0,1,240,299,10134
2,2002,1536,1536,1536,192,1,532,0,9135
2,1926,1281,756,903,25,1,379,378,6120
2,1966,1888,1517,1888,0,0,578,0,16492
2,1987,1479,1645,1479,224,0,578,0,14419
2,1920,861,861,861,0,1,288,0,7404
1,1966,894,894,894,0,1,384,0,7094
1,1910,1368,684,684,0,1,216,684,3600
2,1979,1224,1086,1224,120,0,528,0,7018
2,2008,1590,768,786,0,1,676,804,9000
2,1995,990,990,990,224,1,576,0,13568
3,2007,1464,1485,1464,168,1,754,0,15256
2,1980,1229,561,561,150,0,462,668,1300
0,1949,1588,448,1588,0,1,0,0,12205
3,2002,1689,1568,1689,150,0,857,0,13265
2,1971,1696,1696,1696,0,0,625,0,20693
2,1995,1671,781,781,0,0,423,890,13041
2,1978,1032,1032,1032,0,0,564,0,10395
2,2008,1566,1566,1566,144,1,750,0,9000
2,1970,1004,1004,1004,0,0,480,0,11241
2,1999,1779,951,951,208,0,586,828,13426
2,1950,1640,0,1640,0,0,394,0,21370
2,1995,1239,1230,1239,172,0,477,0,11064
2,2005,1200,600,520,0,1,480,600,3180
3,2008,2046,2046,2046,322,0,834,0,11844
2,2005,1476,738,738,100,1,540,738,8633
1,1954,948,864,948,0,1,248,0,10215
2,2003,1489,782,806,0,0,400,683,8965
2,1959,1588,0,1120,0,0,680,468,17120
1,1961,1774,552,904,290,0,384,611,15400
2,1957,1390,1705,1390,0,0,550,0,39384
1,1922,1048,993,1048,0,0,280,0,6380
2,1994,1516,707,707,0,0,409,809,8803
2,1984,1126,1060,1126,178,1,506,0,7400
1,1953,1647,1105,1647,225,0,280,0,9532
1,1967,1387,943,1387,0,0,300,0,7514
2,1979,1535,0,1535,0,1,400,0,7018
3,2006,1636,1623,1636,0,0,865,0,13501
2,1989,2519,1210,1238,320,0,628,1281,26178
2,2002,1660,831,831,144,1,493,829,8935
0,1936,800,264,800,0,0,0,0,6120
2,1997,1189,1189,1189,0,1,392,0,4500
2,1958,2144,1444,1444,0,0,389,700,159000
2,1925,1548,952,952,74,1,672,596,7264
1,1930,1108,637,1108,0,0,280,0,7449
1,1941,672,672,672,0,1,234,0,9340
2,1995,1470,680,680,192,0,420,790,8139
2,1980,2237,712,1375,305,0,440,862,9839
2,1960,1771,0,1771,0,0,336,0,21750
0,1900,797,245,797,0,1,0,0,9392
2,1964,1092,1092,1092,0,1,504,0,8250
3,2003,2400,1082,1105,114,0,730,1295,13262
2,2007,1372,1363,1372,192,1,588,0,8640
1,1958,1041,1041,1041,0,1,294,0,7350
2,1997,1308,635,646,142,1,497,662,10021
3,2005,1792,1792,1792,204,0,925,0,13758
1,1962,936,896,936,24,0,288,0,6760
3,2006,1537,1518,1537,0,1,788,0,11563
2,1998,1638,943,943,100,0,472,695,9042
1,1941,924,672,672,0,1,280,252,12180
2,1976,958,958,958,0,1,440,0,4928
2,1997,2098,1040,1044,331,0,621,1054,9375
2,1974,1434,1434,1434,80,0,528,0,10200
1,1941,1376,768,968,0,0,240,408,9492
2,2004,848,848,848,149,0,420,0,4426
1,1941,1131,676,676,26,1,200,455,5720
1,1975,918,852,918,192,1,360,0,8750
2,1974,1116,1116,1116,0,0,528,0,10140
3,2006,1959,1088,1088,208,0,1025,871,9000
2,2007,1356,628,628,100,0,484,728,10616
2,1976,1262,1262,1262,298,0,460,0,9600
3,2006,1795,1795,1795,0,0,895,0,9986
2,1974,2067,752,1285,297,0,784,782,12732
3,2006,2140,2140,2140,136,1,894,0,10481
1,1970,1092,546,546,238,1,286,546,2217
3,2008,1808,1774,1808,200,0,850,0,13514
1,1963,1117,1117,1117,0,1,264,0,7590
0,1974,1792,896,896,32,1,0,896,9000
2,1970,1365,765,765,0,1,440,600,2368
3,2006,2748,1850,1850,212,0,850,898,13418
1,1950,1200,1200,1200,126,1,246,0,9600
2,1997,1629,928,928,212,0,482,701,13830
1,1956,1144,1144,1144,44,1,596,0,9571
3,2007,1978,1978,1978,308,0,920,0,12633
3,2007,2078,1034,1050,0,0,836,1028,10800
3,2005,1876,1308,1308,0,1,848,568,11003
1,1967,941,912,941,64,0,288,0,8789
3,1993,2197,1080,1108,385,0,783,1089,10010
2,1999,1739,970,983,115,1,480,756,2645
1,1900,1440,540,889,0,1,352,551,5000
1,1924,1032,1032,1032,0,1,280,0,7741
2,1980,2353,845,1153,288,0,484,1200,13005
2,1960,2069,585,2069,0,0,505,0,27650
1,1945,793,793,793,0,1,240,0,8480
0,1935,754,520,520,53,1,0,0,6780
2,1964,1425,1425,1425,0,0,576,0,10175
2,1976,1060,1040,1060,100,0,572,0,4224
2,2003,1080,530,530,0,1,496,550,2403
2,1978,1664,1529,1664,0,0,663,0,12299
1,1937,1768,731,981,0,0,240,787,7200
2,1914,1264,676,676,424,1,400,588,15564
2,1964,1152,1152,1152,227,0,484,0,14112
0,1955,1152,0,1152,0,1,0,0,6012
2,2000,1936,1406,1454,188,0,504,482,11194
1,1923,1292,949,949,0,1,205,343,5142
2,2007,1266,1266,1266,100,0,388,0,3710
2,2007,1456,728,728,100,1,400,728,7713
1,1926,1422,1290,1422,0,1,352,0,7223
3,2006,1863,879,879,100,0,660,984,14054
2,1989,2559,868,1313,0,0,506,1246,12128
1,1930,1248,912,912,0,1,160,336,9439
3,2006,1962,1391,1391,0,1,868,571,8760
2,1992,1187,1168,1187,483,1,420,0,7980
2,1962,1560,1776,1560,453,0,528,0,11679
2,1998,2393,970,1469,0,0,846,924,3951
2,1964,1452,1420,1452,92,0,572,0,11235
2,2003,1668,1657,1668,0,0,502,0,10635
1,1961,896,882,896,140,1,730,0,11622
2,2004,1659,831,831,144,1,484,828,11920
1,1984,1049,1049,1049,0,1,266,0,4235
0,1946,666,666,666,0,1,0,0,5000
0,1991,974,974,974,0,1,0,0,10712
1,1959,988,988,988,156,1,297,0,9240
2,1953,1094,1094,1094,0,0,495,0,10452
2,1969,1082,973,1082,160,1,480,0,8723
2,1997,1764,928,928,276,1,470,836,15426
2,1993,1642,903,910,290,0,392,732,7655
2,1967,1632,1632,1632,0,1,576,0,25000
1,1960,1422,978,1422,0,0,286,0,12342
2,2004,1245,1235,1245,0,1,495,0,3435
2,1979,914,914,914,0,1,444,0,6950
2,1990,2810,1453,1453,500,0,750,1357,9572
1,1956,1200,1200,1200,0,0,294,0,10400
1,1957,816,816,816,0,1,308,0,7100
2,2002,1762,826,878,320,1,591,884,9930
2,1996,1992,860,1212,225,0,608,780,15295
2,2003,2094,912,912,182,0,615,1182,9375
1,1940,1595,940,1192,0,0,240,403,8400
0,1946,1195,1195,1195,118,1,0,0,8741
2,2005,1611,784,784,144,1,572,827,8400
2,1924,1430,596,834,218,1,370,596,10320
1,1976,1092,546,546,0,1,286,546,1890
3,1999,2365,1252,1268,0,0,856,1097,9430
2,2006,1352,1352,1352,0,0,466,0,4230
2,2004,1535,1517,1535,0,1,532,0,10171
2,2004,1414,707,707,100,0,403,707,9056
2,1976,1964,803,1098,0,0,483,866,10480
1,1930,1755,930,1230,0,0,231,525,7810
1,1939,1322,672,899,0,1,280,423,6240
2,1961,864,864,864,0,1,732,0,8499
2,1951,1220,836,1220,0,1,396,0,8877
2,1974,1309,1040,1309,265,0,484,0,10140
1,1925,765,765,765,135,1,200,0,5000
2,1993,1470,680,680,232,0,420,790,9765
2,1994,1694,392,924,256,0,398,770,10147
2,1988,1873,929,946,108,0,619,927,8883
1,1953,1728,1216,1216,200,0,371,0,12099
1,1928,1477,861,877,0,0,216,600,6292
1,1994,990,990,990,0,1,299,0,8775
2,2003,1094,1094,1094,0,1,576,0,12450
2,1927,1028,1008,1028,0,0,360,0,8960
2,1986,2726,279,2726,216,0,691,0,18044
2,2004,848,848,848,140,0,420,0,4438
2,2008,1726,1726,1726,0,0,561,0,3830
3,2002,1629,1616,1629,0,0,808,0,14536
2,2004,1836,1860,1836,120,0,484,0,9100
2,2004,1812,835,871,146,1,478,941,10628
1,1939,1577,972,972,0,0,312,605,6435
2,1997,1417,1417,1417,60,0,511,0,8750
2,1915,1595,663,774,49,0,528,821,7200
2,2005,1141,1141,1141,0,1,484,0,13072
3,2006,1816,1790,1816,186,0,730,0,12469
3,2007,1704,1704,1704,0,0,772,0,11478
1,1956,1229,1134,1229,0,1,284,0,17140
2,1979,1782,1782,1782,467,0,551,0,14450
2,1980,1032,516,516,213,0,462,516,1879
1,1896,952,756,952,0,1,330,0,8712
2,1999,1344,1344,1344,328,0,686,0,11875
1,1956,1014,0,1014,0,1,267,0,7785
2,1910,1363,622,741,0,1,528,622,7740
2,1966,1839,756,1051,0,0,442,788,7700
1,1954,1128,936,1128,0,1,286,0,9000
3,2007,1615,1615,1615,168,0,864,0,9345
1,1972,1030,494,494,0,1,264,536,1890
1,1920,1657,1147,1147,0,0,162,510,5520
2,1959,1712,1626,1712,272,1,588,0,8393
2,2003,848,848,848,140,1,420,0,4435
2,1979,1535,0,1535,0,1,410,0,7018
2,1998,1772,928,928,150,0,492,844,8750
1,1941,2340,1152,1188,0,0,252,1152,9042
2,1976,1548,804,804,48,0,440,744,2308
0,1931,1666,894,894,0,0,0,772,9839
4,1997,1344,1344,1344,0,1,784,0,7060
3,2008,2713,1452,1476,126,0,858,1237,14948
2,2003,848,848,848,140,1,420,0,4435
1,1928,1143,1008,1143,265,0,288,0,7111
1,1939,845,0,640,48,1,256,0,11067
0,1958,960,960,960,0,1,0,0,6410
1,1936,2057,1017,1020,0,0,180,1037,11500
1,1957,1638,967,967,0,1,384,671,9060
2,1948,1687,747,1687,0,0,572,0,57200
2,2000,1524,756,768,0,1,440,756,2998
1,1880,1750,636,1089,0,1,240,661,9000
2,1974,894,864,894,0,1,440,0,11800
2,1900,1798,1075,1156,0,1,342,642,9639
1,1923,1200,1200,1200,0,1,312,0,11340
2,2006,1652,1652,1652,404,0,840,0,13173
2,1954,1640,1296,1640,108,0,924,0,14778
2,2004,1709,970,970,0,1,380,739,2522
1,1924,1221,784,949,0,1,392,272,9738
2,1941,803,720,803,0,1,360,0,5000
2,2007,1396,608,608,100,0,440,788,11069
0,1916,936,216,576,0,1,0,360,8520
1,1968,1052,1052,1052,356,1,288,0,8400
2,2007,1768,866,866,144,1,578,902,10769
2,2005,1686,891,891,144,1,462,795,7800
2,1998,1604,926,926,100,1,472,678,9535
2,1910,2104,1226,1226,0,1,432,878,6300
2,1919,1824,764,1060,0,0,520,764,13515
2,1993,2232,1173,1215,173,0,623,1017,11692
2,1958,1920,1052,1252,0,0,451,668,13650
2,2003,2014,912,1072,124,1,486,942,9157
2,1988,1228,1228,1228,168,0,472,0,4671
2,1949,1556,782,1019,0,0,470,537,17360
2,1947,1664,1004,1004,0,0,420,660,5000
1,1971,987,483,483,0,1,264,504,1680
2,1968,1556,727,829,0,1,441,727,11700
2,2006,1625,1573,1625,123,0,538,0,4750
2,2003,1700,1682,1700,192,1,544,0,9135
1,1958,1955,1151,1151,0,1,356,804,9000
1,1945,808,0,808,0,1,164,0,6120
2,1929,854,832,854,48,1,576,0,6120
1,1958,1138,588,1138,224,1,264,0,10482
2,1999,1675,841,892,0,0,502,783,24682
2,1990,1341,1300,1341,192,0,506,0,10176
1,1968,1196,1196,1196,257,1,336,0,10044
3,2008,3140,1926,1966,144,0,820,1174,13518
1,1910,1273,616,1055,212,1,275,218,11388
3,1928,2009,672,1337,0,0,795,672,19950
3,1993,2097,1080,1080,196,0,678,1017,11228
2,1915,1768,1048,1048,0,1,576,720,8094
1,1924,1669,1093,1093,0,1,288,576,8707
2,1970,2207,1947,2207,301,0,576,0,19900
2,2003,1663,835,835,168,1,478,828,12774
2,1993,1190,1181,1190,0,0,430,0,7250
2,2005,1504,1346,1504,156,0,437,0,3182
2,1996,2049,1065,1065,120,0,467,984,21533
1,1942,1494,771,753,0,0,213,741,7500
2,1958,1261,1261,1261,0,0,433,0,9120
2,1975,1552,713,811,209,0,434,741,11475
2,1993,1501,697,697,190,0,420,804,7685
0,1919,1517,793,997,0,1,0,520,8500
1,1926,1111,572,572,0,0,288,539,5700
1,1969,971,971,971,0,0,300,0,9920
1,1900,1836,686,1150,0,1,288,686,56600
3,2005,1698,1698,1698,192,0,730,0,11520
2,1969,1026,1026,1026,171,1,440,0,7930
2,2006,1612,1612,1612,0,0,556,0,8035
1,1966,1128,1080,1128,238,0,315,0,11380
3,2005,2795,1390,1390,272,0,660,1405,15922
2,1995,1680,1680,1680,152,1,628,0,17871
3,2007,2520,1508,1508,192,0,640,1012,23303
1,1951,1600,0,1600,0,1,270,0,31250
2,1990,1332,1332,1332,0,1,542,0,7175
1,1950,1904,1208,1136,0,1,240,768,7200
3,2009,2020,2006,2020,156,0,900,0,12220
3,2006,2338,2660,2338,0,0,1110,0,51974
2,2006,1458,608,608,100,1,454,850,13204
1,1965,960,648,960,88,1,364,0,10246
2,2004,1694,1686,1694,255,0,636,0,10084
3,2005,2482,1094,1133,144,0,642,1349,12665
2,1959,1580,1244,1580,0,0,440,0,10032
1,1966,1092,1092,1092,259,1,264,0,9825
2,1997,2034,1057,1057,576,1,645,977,9375
0,1940,996,996,996,144,0,0,0,13907
2,1977,1432,716,716,0,0,531,716,8286
0,2006,1140,1140,1140,36,1,0,0,17217
2,1994,2110,948,1222,0,0,463,888,8880
3,2007,2100,918,958,172,0,786,1142,9709
2,1969,1308,720,720,0,1,484,588,9743
0,1987,1200,1200,1200,120,1,0,0,10800
2,2008,1402,1402,1402,205,1,625,0,8640
1,1967,1107,949,1107,88,1,308,0,8050
2,1977,1969,808,1161,0,0,534,808,11952
2,1965,1820,864,902,60,0,492,918,13700
0,1920,605,528,605,0,1,0,0,9098
2,2000,1514,794,819,0,0,394,695,8433
2,1979,2233,0,1100,0,1,579,1133,9555
2,2000,1638,1614,1638,230,0,495,0,4765
0,1970,1092,546,546,0,1,0,546,1526
3,1999,2270,1152,1164,132,0,671,1106,11764
2,1993,1337,1337,1337,96,0,462,0,5395
1,1910,1635,485,1001,394,1,255,634,5310
1,1971,950,950,950,0,1,280,0,9758
2,1971,864,864,864,0,1,576,0,7560
1,1961,1150,1150,1150,0,1,288,0,7000
3,1935,3447,728,1968,314,0,1014,1479,14100
1,1926,1616,1149,1149,0,1,216,467,5400
1,1948,1668,1212,1226,0,1,240,442,9600
1,1921,1424,1228,1424,0,0,312,0,7290
2,1999,1557,1557,1557,124,0,484,0,4109
2,1957,1790,998,1790,0,0,540,0,14250
2,2006,2021,868,887,0,0,422,1134,23257
2,1999,1588,1588,1588,158,1,472,0,10264
2,1994,1721,928,936,300,1,471,785,8462
2,2003,1121,1121,1121,132,1,440,0,8546
3,1997,2551,1779,1779,76,0,925,772,12191
2,1978,1373,1319,1373,0,0,591,0,7424
2,2005,1714,1714,1714,156,0,517,0,8147
2,1978,1295,1057,1295,133,0,571,0,3840
2,1948,1323,780,948,0,1,400,375,9184
1,1960,1134,1010,1134,0,1,254,0,7000
2,1972,1193,1153,1193,140,1,501,0,13110
1,1901,1214,969,969,0,1,216,245,5680
1,1956,1196,1196,1196,0,0,297,0,9000
2,2004,1646,1594,1646,128,0,482,0,3811
3,2006,2698,1850,1850,250,0,736,848,16052
2,1957,1347,1347,1347,0,1,551,0,5805
2,1964,1775,533,1131,0,1,480,644,10600
2,1910,1306,240,810,0,1,472,496,15660
2,2003,1320,660,660,0,1,400,660,7750
2,1972,894,894,894,215,1,600,0,7200
1,1948,789,789,789,0,1,250,0,6000
2,2001,2439,1531,1531,184,0,560,908,12728
2,1999,1452,691,713,0,1,506,739,3735
1,1966,988,988,988,0,1,360,0,7150
2,1969,1632,784,784,0,0,898,848,10457
2,2006,1491,738,738,100,0,484,753,8333
3,1995,3238,2033,2053,283,0,666,1185,14720
2,1900,2414,954,1766,142,0,520,648,10800
2,1965,1728,1728,1728,0,1,576,0,13101
2,1977,1602,1602,1602,240,0,529,0,16635
2,2003,1146,868,1146,160,0,438,0,9590
2,2002,1509,783,807,100,0,393,702,7861
2,1900,2014,716,1007,0,1,624,1007,9856
2,1962,2448,1438,1900,520,0,441,548,18275
2,1959,3820,0,3820,0,0,624,0,47007
1,1961,864,864,864,158,1,440,0,9079
1,1959,1246,1246,1246,218,1,305,0,7500
2,1999,1549,744,757,0,1,440,792,2280
1,1948,1271,720,720,0,0,312,551,21286
1,1920,840,798,840,112,1,250,0,5747
2,1988,1179,1166,1179,0,1,480,0,4740
2,2006,1208,1187,1208,105,1,632,0,6762
2,1910,1230,440,682,74,1,440,548,10440
2,2002,1795,1777,1795,171,0,534,0,9742
3,2008,5095,5095,5095,546,0,1154,0,39290
2,1900,1951,938,1084,0,1,576,867,7745
3,1996,2340,1236,1236,192,0,787,1104,14311
3,2008,1578,1573,1578,0,0,840,0,9262
2,2000,1382,673,673,153,1,490,709,2651
2,1980,1472,1372,1472,233,0,588,0,14115
2,1999,1644,941,961,460,0,460,683,9649
2,2008,1884,1884,1884,231,0,649,0,7390
2,2005,1223,600,520,0,1,480,623,2544
1,1980,1700,430,880,188,1,450,680,1700
0,1977,1440,1440,1440,321,1,0,0,7711
2,2002,1459,1459,1459,192,0,527,0,8749
1,1953,773,773,773,0,1,240,0,7677
1,1945,1668,672,1195,210,1,252,473,7425
2,1995,1200,1200,1200,0,1,521,0,11249
1,1950,1078,1078,1078,366,1,240,0,9717
1,1963,1045,1045,1045,0,0,264,0,7936
2,1990,1339,1309,1339,0,0,484,0,8049
3,2006,1795,900,909,168,0,782,886,10603
2,1990,1442,910,1442,0,0,719,0,10357
2,1950,1048,0,1048,0,1,420,0,7200
2,2005,1456,728,728,100,1,400,728,8029
2,1959,1466,1466,1466,0,0,528,0,17755
2,1963,1328,1328,1328,0,0,528,0,9790
1,1956,882,882,882,0,1,502,0,13008
1,1959,1328,1350,1328,0,0,308,0,16905
2,2007,1528,1528,1528,0,0,480,0,9965
2,2004,1422,1422,1422,192,1,626,0,8500
2,1953,950,984,950,0,1,400,0,12774
2,1988,1714,980,980,228,0,496,734,10421
2,2003,1768,884,884,0,1,543,884,8158
1,1960,1507,1075,1507,0,1,404,0,7910
2,1941,1382,720,854,237,1,660,0,12358
3,2006,1646,1638,1646,192,0,870,0,10656
3,2004,1576,1393,1576,143,0,668,0,3940
2,1963,970,970,970,0,1,624,0,8480
1,1950,1952,976,976,285,0,299,976,9780
2,1993,2495,1280,1280,224,0,660,1215,10791
1,1945,640,0,640,0,1,240,0,8777
2,1977,1844,1844,1844,0,0,546,0,11751
2,2006,1364,1220,1364,100,0,437,0,3087
2,1994,990,990,990,0,1,480,0,8072
2,1976,1398,684,684,0,0,440,714,7200
2,1951,1112,631,1112,0,1,480,0,13070
0,1964,912,912,912,0,1,0,0,8020
2,1964,1516,1516,1516,0,1,472,0,10004
2,1915,1308,880,880,0,1,400,428,10320
1,1925,1608,976,1160,147,0,216,448,6171
1,1961,914,914,914,140,1,270,0,17199
2,1940,1567,840,840,0,0,440,727,13680
2,1990,1717,1156,1187,168,0,400,530,13758
2,1951,1226,0,1226,174,0,400,0,13108
1,1940,1308,728,976,0,0,256,332,9600
1,1959,1144,1144,1144,86,0,796,0,8163
2,2005,1530,1530,1530,168,0,430,0,16158
2,2007,1792,896,896,184,1,590,896,8640
2,1964,1488,1008,1488,154,0,430,0,10368
2,1996,1040,1040,1040,168,1,576,0,12464
2,1916,1196,1196,1196,0,1,440,0,4800
1,1968,874,864,874,0,1,288,0,10172
0,1923,2592,1296,1296,0,1,0,1296,10890
2,1961,1187,864,1187,128,0,440,0,14357
2,2004,848,848,848,149,0,420,0,4438
2,1999,1501,744,757,0,1,440,744,2280
2,1950,2177,1032,1102,0,1,484,1075,15600
2,1951,1575,216,1575,0,0,400,0,10170
2,1924,1566,816,816,24,1,450,750,6000
2,1998,1478,1418,1478,168,1,495,0,7380
1,1954,1268,1268,1268,0,0,244,0,7800
2,2007,1218,1218,1218,0,1,576,0,9605
1,1959,1040,1040,1040,140,1,286,0,7560
2,2005,1577,1577,1577,203,0,564,0,7841
1,1971,1092,525,525,0,1,320,567,1680
2,1979,2228,0,1114,73,1,720,1114,7018
2,1929,1316,926,926,0,1,484,0,5500
2,2004,1445,1445,1445,0,1,470,0,9750
2,2005,1768,866,866,0,1,603,902,9803
2,1996,1288,1260,1288,120,0,500,0,14963
2,1971,1220,1625,1220,0,0,944,0,13001
2,1955,960,960,960,0,1,576,0,6000
3,2004,1713,1713,1713,0,0,856,0,9591
1,1958,1442,1442,1442,0,1,301,0,9750
1,1953,930,911,930,134,1,286,0,9520
2,2000,1674,814,814,0,1,663,860,7500
2,2003,1394,384,754,100,0,400,640,11950
3,1995,2531,1318,1328,222,0,752,1203,12257
2,2001,2035,884,884,144,0,434,1151,9505
1,1975,1096,1008,1096,0,0,352,0,6305
3,1993,2799,1286,1565,432,0,704,1234,12585
1,1885,1047,641,1047,0,1,273,0,10800
1,1998,767,723,767,120,1,367,0,4058
2,2005,1302,1302,1302,110,0,631,0,3901
2,1989,1495,1495,1495,252,0,438,0,12890
1,1976,1125,1041,1125,296,0,352,0,7200
1,1930,813,813,813,0,1,270,0,5684
1,1963,1651,725,1035,460,0,276,616,10090
2,1985,1502,1488,1502,0,1,528,0,6820
3,2001,2633,2633,2633,314,0,804,0,11400
1,1976,894,894,894,365,1,308,0,10650
1,1920,1012,1012,1012,0,0,308,0,8263
2,1988,1680,880,1680,292,0,540,0,21695
1,1916,2526,714,1664,88,0,216,862,8520
3,2004,2224,1462,1462,184,0,738,762,8834
1,1940,2403,1032,1207,56,0,349,1196,24090
2,1938,1969,1272,1272,0,0,400,0,6876
1,1967,1141,1141,1141,0,1,568,0,9600
2,2006,1278,1278,1278,0,1,584,0,8640
2,1986,1501,1277,1501,240,0,512,0,4084
2,1968,1721,1461,1721,0,0,440,0,10335
2,2005,1904,1058,1058,179,0,736,846,10927
2,1990,1061,1054,1061,114,1,462,0,10778
2,1940,908,822,908,284,1,512,0,12172
2,1984,1097,1040,1097,0,1,480,0,9672
1,1910,810,0,810,119,1,280,0,21780
2,1974,894,864,894,241,0,440,0,13350
2,1966,1280,793,1280,140,0,432,0,10050
2,1999,1404,672,684,20,1,462,720,2160
1,1967,992,992,992,204,1,294,0,10265
2,1935,2108,1127,1236,0,0,540,872,13728
0,1972,630,630,630,96,1,0,0,1491
1,1940,1510,755,755,120,0,296,755,9084
1,1945,2320,1028,1436,224,0,180,884,7259
2,1992,1280,1280,1280,0,1,506,0,5070
2,1998,2362,1220,1220,147,0,1105,1142,8413
2,1976,1142,1142,1142,536,0,528,0,4224
2,1976,1728,1728,1728,40,1,574,0,12640
1,1966,892,864,892,0,1,416,0,7800
2,1970,1682,1304,1682,98,0,530,0,10400
2,1995,2020,1128,1142,0,0,466,878,9828
2,1948,1320,768,819,108,1,576,501,8064
1,1942,1644,728,888,168,0,312,756,9480
3,2007,1466,1466,1466,100,1,610,0,8925
2,2006,1484,1476,1484,120,0,472,0,9037
2,1999,1873,988,988,202,0,597,885,10820
3,2005,2541,1149,1164,120,0,729,1377,12328
1,1959,1183,528,1183,0,1,288,0,8000
1,1980,1266,630,630,340,0,283,636,8012
2,2004,1374,384,744,0,1,400,630,9734
1,1948,869,0,869,0,1,390,0,10122
3,2005,2212,1700,1700,237,0,773,512,13751
3,2008,1702,1702,1702,0,0,1052,0,8769
1,1920,865,660,740,0,0,216,125,10042
3,2006,2596,1249,1249,240,1,840,1347,16259
2,1971,981,981,981,0,1,576,0,10530
2,1959,1801,1501,1801,0,0,484,0,15602
1,1925,1328,686,810,0,1,210,518,9906
1,1930,1001,837,1001,154,1,216,0,6060
1,1938,1360,803,803,0,1,297,557,7200
1,1957,1526,1216,1526,116,0,364,0,8562
2,2005,1422,704,704,36,0,440,718,11646
1,1965,935,935,935,180,1,288,0,13526
2,2005,1266,1257,1266,38,0,453,0,7500
1,1922,2068,1108,1160,0,0,315,908,7793
1,1958,1329,1329,1329,393,1,312,0,14267
2,1983,2132,1496,1496,349,0,612,636,12327
3,2005,1595,1595,1595,144,0,880,0,8987
2,1994,2127,1223,1223,171,0,525,904,10944
2,2000,1673,1673,1673,306,0,583,0,11354
2,1995,1253,1237,1253,220,0,402,0,7875
0,1970,1092,546,546,187,1,0,546,1477
2,1977,2263,795,1468,0,0,539,795,16659
2,2005,1200,600,520,0,1,480,600,3180
1,1931,1502,776,851,0,0,270,651,7200
2,2003,848,848,848,140,1,420,0,4435
2,2006,2234,2220,2234,390,0,724,0,14082
1,1969,1216,1216,1216,0,1,336,0,9000
2,1979,1725,539,1040,0,0,550,685,11584
2,2002,1989,1065,1091,199,0,586,898,11367
3,2006,1838,1838,1838,270,0,765,0,14601
2,1959,1252,1252,1252,0,1,528,0,10721
2,2007,1246,1146,1246,100,0,428,0,3710
3,1995,1511,1401,1511,168,0,811,0,11454
1,1956,960,672,960,64,1,288,0,8926
2,2002,1812,952,952,144,0,469,860,7500
1,1926,789,768,789,0,1,200,0,10594
2,1950,1040,0,1040,0,1,420,0,7200
3,1994,2526,1165,1203,309,0,844,1323,10120
3,2008,1743,1739,1743,168,0,927,0,10367
2,1962,1211,864,1211,161,0,576,0,9240
2,1918,1416,816,1416,0,1,576,0,25339
1,1939,1412,780,825,45,0,280,587,6000
3,2009,1940,1930,1940,168,0,606,0,10159
2,2005,1456,728,728,0,0,390,728,8461
1,1971,987,483,483,275,1,264,504,1680
2,1999,1586,960,962,169,1,480,624,2645
1,1950,1152,1092,1152,0,0,300,0,14000
1,1972,864,864,864,0,1,352,0,7180
1,1972,1092,525,525,352,1,264,567,1680
2,1991,1274,624,624,22,1,576,650,10475
1,1977,926,902,926,319,0,351,0,9750
1,1930,1426,966,1014,174,0,230,412,6240
2,1977,1654,0,1286,0,1,528,368,8927
2,1981,1740,1740,1740,228,1,540,0,15417
2,2006,1534,1524,1534,168,0,484,0,10612
2,1955,1779,1763,1779,0,0,454,0,17920
2,1977,1040,1040,1040,0,1,484,0,8800
1,1958,1339,1029,1339,0,1,294,0,7560
2,1956,1689,1436,1689,0,0,480,0,9855
1,1922,1154,796,796,0,1,240,358,5436
2,2002,1908,967,993,135,1,431,915,14191
3,2006,1973,1935,1973,315,0,895,0,14226
2,1998,2031,1153,1153,192,0,541,878,11404
1,1965,1020,1024,1020,171,1,288,0,9316
3,2004,1618,1618,1618,0,0,880,0,16163
2,2007,1504,752,752,100,1,440,752,8229
2,1976,1062,1029,1062,120,0,539,0,11333
1,1961,912,912,912,168,1,288,0,6768
2,2004,1374,384,744,100,0,400,630,9434
2,1928,1378,689,689,0,0,360,689,9600
2,1972,1381,1161,1381,0,0,676,0,9360
4,1997,1368,1288,1368,0,1,784,0,7020
2,2007,1208,1208,1208,105,1,628,0,6762
2,1997,1950,975,975,0,0,576,975,7399
2,1975,879,864,879,0,1,440,0,9675
2,1948,1527,699,801,0,0,410,726,11419
2,1947,1312,784,900,0,1,649,412,7500
2,1976,1620,1281,1620,120,0,490,0,9991
1,1963,960,960,960,168,1,300,0,9239
2,2004,1484,1473,1484,0,1,606,0,8400
1,1925,1159,747,747,84,1,288,412,7506
2,1977,1334,1350,1334,0,0,630,0,9650
3,2008,1346,1336,1346,100,0,660,0,11896
2,1978,1386,672,672,335,0,440,714,11616
2,2004,1374,384,744,100,0,400,630,13300
3,2009,1766,1766,1766,195,0,478,0,9187
3,2008,1468,1468,1468,210,0,898,0,9612
3,2005,1801,893,901,0,0,800,900,10463
1,1967,900,864,900,175,0,288,0,7838
2,1925,1694,1181,1390,342,0,576,304,8400
2,1968,1743,702,1041,224,0,539,702,11700
2,1977,980,980,980,192,1,484,0,7064
3,2007,1861,1341,1341,144,0,851,520,9801
1,1957,907,907,907,0,1,352,0,8593
2,1994,1097,1097,1097,392,1,672,0,10859
2,2003,2314,1150,1164,0,0,502,1150,11060
1,1938,1551,1058,1058,0,1,240,493,10890
2,1916,1232,816,1232,0,0,440,0,8574
2,2005,1541,1541,1541,0,0,532,0,12182
2,1993,1571,799,799,0,0,380,772,7837
2,1928,1981,1122,1328,431,0,576,653,7804
0,1910,1184,658,658,0,1,0,526,8410
2,2004,1221,1221,1221,0,1,400,0,7500
1,1914,864,864,864,0,1,200,0,8212
2,1998,2097,1108,1108,253,0,583,989,9750
1,1977,1026,1026,1026,316,1,308,0,15240
3,2008,1630,1622,1630,172,0,860,0,10226
2,1998,1886,930,956,89,0,431,930,11214
2,1982,858,858,858,120,1,576,0,7252
2,1978,1671,1427,1671,252,0,484,0,10928
1,1890,725,630,725,0,1,320,0,10800
2,2005,1716,858,858,0,1,615,858,8125
1,1959,1194,1194,1194,0,1,312,0,8760
1,1967,1073,1073,1073,0,1,270,0,9981
1,1935,1738,1024,1144,0,0,240,594,7010
1,1939,1274,728,728,0,1,224,546,6125
2,2008,1436,1436,1436,0,1,529,0,7993
1,1953,1154,864,1154,63,1,336,0,11556
2,1920,1762,596,998,36,1,576,764,7200
1,1955,1057,1057,1057,0,1,288,0,10519
3,2006,1402,1258,1402,120,0,648,0,3922
2,1988,1872,1845,1872,197,0,604,0,10400
2,2001,1961,804,804,125,0,560,1157,12209
2,1961,1433,1251,1433,144,0,441,0,9600
2,2000,2256,952,980,224,0,554,1276,8795
3,2000,1865,992,992,0,0,839,873,10316
1,1940,612,0,612,0,1,308,0,5925
0,1910,816,624,816,0,0,0,0,3300
2,2007,1361,1351,1361,0,1,610,0,9627
1,1966,1059,1059,1059,0,1,286,0,9000
2,1976,1548,804,804,108,0,440,744,2308
3,2000,2285,969,997,0,0,648,1288,11000
3,2007,1620,1620,1620,228,0,912,0,12898
3,2005,2331,1414,1414,192,0,1003,917,12151
2,1927,1718,851,867,291,0,264,851,7230
3,1993,2349,1231,1251,32,0,762,1098,13143
2,1923,1635,1065,915,0,0,440,720,8737
2,2001,1419,1419,1419,155,0,588,0,4385
1,1962,999,999,999,0,1,264,0,7758
0,1987,1200,1200,1200,120,1,0,0,10800
1,1927,968,656,968,0,1,216,0,10800
2,2001,1434,1454,1434,290,0,527,0,8529
1,1954,948,948,948,0,0,280,0,8190
1,1937,1375,780,780,0,0,544,595,9000
2,1955,1588,768,1024,0,1,480,564,7200
2,1986,2093,791,1236,364,0,542,857,20544
1,1957,1600,1484,1600,288,0,319,0,16321
3,2008,2020,2020,2020,192,0,896,0,12350
1,1962,1696,1140,1696,0,0,349,0,13673
2,1926,1285,861,861,96,1,506,424,7000
2,2003,848,848,848,140,1,420,0,4435
2,1940,1656,801,1095,187,1,440,561,7628
2,1986,1651,1606,1651,192,0,616,0,12416
1,1977,1388,675,686,406,1,317,702,8340
0,1947,1137,0,929,0,1,0,208,8050
2,1958,951,951,951,0,1,480,0,8010
2,1995,1609,754,754,0,1,525,855,8453
1,1966,892,864,892,0,1,264,0,9477
1,1950,1113,1113,1113,0,0,264,0,9600
2,2004,1436,1436,1436,139,1,484,0,8450
3,2001,1787,1753,1787,198,0,748,0,14781
1,1954,901,901,901,0,1,281,0,6000
2,2003,2048,1054,1072,0,0,552,976,8010
2,1981,2497,2461,2497,266,0,676,0,17778
2,2005,1838,732,734,100,0,372,1104,21930
2,1964,1611,780,798,328,1,442,813,9760
2,1962,1734,912,1085,0,0,440,649,9786
2,2005,1484,783,783,0,0,393,701,10237
2,1977,2022,1160,1156,288,0,505,866,10005
2,2003,1653,812,812,0,1,628,841,8127
3,2008,2018,2002,2018,144,0,746,0,13214
3,2002,1668,1626,1668,257,0,702,0,11248
2,1987,1767,1064,1064,441,0,504,703,5306
3,2008,2822,1734,1734,52,0,1020,1088,13891
3,2009,1680,1555,1680,185,0,1138,0,10933
3,2004,1836,1836,1836,125,0,862,0,11362
3,2005,1614,1614,1614,144,1,865,0,11210
2,2005,1468,1468,1468,0,0,528,0,10440
2,1966,1232,1232,1232,0,1,490,0,9600
3,2006,1746,1746,1746,201,0,758,0,14892
2,2001,2263,1055,1055,0,0,905,1208,9240
1,1965,1565,1187,1565,200,0,299,0,8800
1,1955,960,960,960,0,1,330,0,9768
1,1964,1728,1728,1728,155,1,352,0,10624
2,2004,1959,847,847,100,0,434,1112,11796
4,2005,2790,1620,1632,30,0,1150,1158,12539
3,2005,1964,1964,1964,0,0,892,0,11447
2,2000,1573,756,769,0,1,440,804,2117
2,1963,1394,1394,1394,0,0,514,0,9500
1,1972,768,768,768,192,1,396,0,7200
2,1966,1348,660,660,188,0,453,688,7590
2,2004,1947,991,991,0,0,678,956,12552
2,1978,1096,1008,1096,168,0,484,0,13014
2,1969,1968,784,1168,305,0,530,800,11075
3,2009,1544,1544,1544,0,1,868,0,12883
1,1926,986,960,986,0,0,180,0,6180
2,2003,2486,1122,1146,143,0,452,1340,11800
2,2005,1506,1362,1506,142,0,440,0,3013
2,1962,1716,858,858,0,0,490,858,9247
3,1941,2039,929,2039,0,0,791,0,21299
1,1949,480,480,480,0,1,308,0,9000
3,1892,3608,1107,1518,0,0,840,1518,22950
3,2004,1850,1833,1850,519,0,772,0,16033
3,2006,2473,1094,1102,246,0,675,1371,12292
3,2003,1629,3206,1629,0,0,880,0,10655
2,2004,1200,600,600,0,1,480,600,3182
1,1958,912,912,912,0,1,275,0,10150
2,1975,1074,1056,1074,0,1,495,0,10140
3,2006,1830,1302,1302,0,1,859,528,8778
1,1940,672,672,672,88,1,308,0,5400
1,1950,988,876,988,0,1,276,0,7200
2,1952,1474,1632,1474,0,0,495,0,31220
1,1978,907,907,907,72,1,343,0,16269
3,2007,1542,1542,1542,168,0,852,0,11830
3,1998,2450,1284,1310,0,0,1069,1140,16545
3,2002,1654,1654,1654,0,1,900,0,8125
2,1932,1991,854,1096,0,0,432,895,11275
2,2002,1729,860,860,386,1,542,869,8158
0,1900,2200,1272,1272,0,1,0,928,8777
3,1963,1572,1572,1572,0,0,995,0,35133
2,1924,949,949,949,0,0,370,0,6000
1,1976,1304,264,616,141,0,336,688,2665
0,1955,1152,0,1152,0,1,0,0,6882
1,1950,1074,663,1074,0,0,467,0,11479
3,2005,2728,1848,1848,0,0,706,880,20431
2,2003,1342,698,698,100,0,393,644,8174
2,2000,1512,756,756,0,0,440,756,2117
3,2007,2772,1776,1794,135,0,754,978,14257
4,2000,2787,1168,1168,312,0,820,1619,7939
1,1971,1050,1043,1050,0,1,336,0,8510
3,2005,2046,1994,2046,188,0,878,0,15431
2,1966,1988,1104,1104,0,0,480,884,14670
2,1976,1479,725,725,0,1,475,754,13517
2,2001,1593,1593,1593,0,0,682,0,4923
1,1941,1210,672,832,0,1,240,378,5000
2,1995,1658,773,773,224,0,431,885,8000
2,1950,864,864,864,194,1,720,0,7200
2,1999,1416,696,696,0,1,484,720,2572
2,2007,1162,1162,1162,0,1,483,0,9260
1,1916,1656,660,808,0,1,180,704,10410
2,1971,810,782,810,0,1,576,0,10820
1,1956,1048,1048,1048,0,1,286,0,10152
1,1972,1302,630,630,0,1,264,672,1680
2,2000,1525,1525,1525,219,1,541,0,9100
2,2005,2253,1209,1209,243,0,575,1044,12867
1,1960,1269,1269,1269,0,0,308,0,7931
0,1970,1344,546,798,0,0,0,546,1533
2,1983,884,840,884,240,1,504,0,9180
3,2005,2358,1524,1544,120,0,784,814,11643
2,1957,1839,1477,1839,0,0,416,0,14442
3,2004,1884,1884,1884,214,0,670,0,15401
1,1920,1362,951,986,0,1,280,376,7550
2,1956,1728,1048,1728,0,0,576,0,13495
1,1975,938,938,938,145,1,308,0,9200
1,1962,1812,864,876,0,0,264,936,7590
0,1955,1152,0,1152,0,1,0,0,6845
1,1959,1256,1256,1256,0,1,311,0,8000
2,1978,1456,855,855,147,0,440,601,2364
1,1926,1479,624,743,530,0,312,736,7000
2,1992,1845,1055,1055,635,0,462,790,11218
2,1952,1488,0,1488,0,0,569,0,12048
2,1967,1510,1510,1510,0,1,517,0,9680
2,1957,1392,1392,1392,0,0,458,0,11900
1,1940,804,788,804,0,0,240,0,7200
2,2006,1241,1241,1241,0,1,569,0,4274
2,1974,1350,1064,1350,0,0,478,0,10140
2,2005,1500,750,750,0,1,564,750,8846
2,1976,954,911,954,0,1,576,0,10780
3,2002,1786,1778,1786,182,0,715,0,14860
1,1967,900,882,900,0,1,280,0,9819
3,1995,2113,2109,2113,236,0,839,0,10437
2,1946,1958,979,979,0,1,492,979,7136
3,2006,1694,1694,1694,0,0,856,0,11825
2,1908,2358,907,1307,486,0,360,1051,45600
3,2003,3279,1650,1690,503,0,841,1589,53504
2,2000,1652,1494,1652,96,1,499,0,5330
1,1977,894,894,894,192,1,308,0,6285
2,1978,1857,945,945,400,0,482,912,10530
2,2005,1336,1336,1336,136,1,502,0,8772
2,1991,1689,1680,1689,428,0,432,0,9990
3,1999,2312,1177,1223,298,0,658,1089,15896
1,1930,1162,728,728,0,1,258,434,6120
1,1957,1176,1176,1176,0,0,292,0,8856
3,2007,1698,1698,1698,327,0,768,0,13286
1,1936,1324,672,757,0,1,240,567,6000
0,1918,1020,1020,1020,0,1,0,0,4761
1,1900,1178,859,859,68,1,384,319,8712
2,2004,1640,798,798,138,1,520,842,8366
2,1954,1663,1364,1663,224,0,529,0,53227
2,1968,1388,1388,1388,0,0,522,0,12000
3,2006,1670,1670,1670,0,0,928,0,15218
2,1970,2217,2217,2217,81,0,621,0,15865
1,1957,1364,1179,1364,0,0,331,0,8400
2,1969,1054,1054,1054,180,1,460,0,9750
1,1924,1142,468,822,0,1,320,320,6000
1,1930,1654,297,1001,244,0,336,653,4960
2,2004,1374,384,744,100,0,400,630,11084
2,1970,768,768,768,104,1,624,0,7244
1,1982,816,816,816,0,0,264,0,6600
2,1970,2411,1008,1403,0,0,570,1008,8000
1,1936,1639,1064,1166,0,1,240,0,10480
1,1967,892,892,892,0,1,288,0,7150
1,1958,912,912,912,12,1,297,0,7535
2,1982,845,845,845,0,1,360,0,7599
2,2002,1894,817,824,0,0,510,1070,11316
1,1950,1252,1032,1032,0,1,288,220,9600
0,1945,670,370,442,0,1,0,228,3500
2,1999,1647,953,953,0,0,460,694,7917
2,1965,1728,1728,1728,0,1,576,0,11072
1,1965,894,894,894,416,0,336,0,8450
2,1981,1479,725,725,167,0,484,754,12090
2,1953,1505,1505,1505,0,0,505,0,12160
0,2006,1100,1100,1100,0,1,0,0,7500
2,2006,1486,1461,1486,0,1,566,0,7441
2,2006,1448,1372,1448,0,0,692,0,7500
2,1961,1235,1235,1235,0,1,480,0,8500
1,1970,914,914,914,120,1,368,0,7920
1,1927,1642,728,914,0,0,374,728,9863
1,1962,1040,1040,1040,0,1,260,0,6897
3,1969,1424,1100,1424,144,1,828,0,41600
2,1967,2126,1013,1160,486,1,538,966,28698
1,1970,864,864,864,0,1,280,0,9353
1,1915,1680,840,840,0,1,308,840,15576
1,1940,672,672,672,168,1,240,0,10200
2,1963,1128,1120,1128,192,1,525,0,8700
2,1993,1797,1152,1152,162,0,616,645,12961
0,1940,599,416,599,0,1,0,0,5400
2,1968,1440,720,720,192,0,480,720,11227
1,1954,833,833,833,0,1,326,0,5400
3,2001,2649,1479,1515,0,0,746,1134,16900
3,2000,2855,1540,1540,247,0,774,1315,9233
3,1932,1609,637,959,0,0,579,650,12320
2,1977,2620,1361,1361,155,0,600,1259,18890
3,2006,2322,1035,1082,400,1,617,1240,12104
2,1977,1676,1160,1676,690,0,672,0,33983
2,1991,1478,1454,1478,114,0,506,0,9928
2,2003,1456,1273,1456,143,0,400,0,3196
0,1920,720,720,720,0,1,0,0,7879
2,2004,1102,551,551,0,1,480,551,5105
2,1958,960,960,960,0,1,624,0,9750
2,1975,1701,1390,1701,0,0,611,0,16647
2,1955,1005,1005,1005,0,0,672,0,10434
2,1968,1051,1051,1051,0,1,504,0,9600
0,1914,1484,742,742,0,0,0,742,6300
