Garage_Cars,Year_Built,Gr_Liv_Area,Total_Bsmt_SF,First_Flr_SF,Wood_Deck_SF,Fireplaces,Lot_Area,Garage_Area,Second_Flr_SF
2,1996,1553,691,691,0,0,7875,420,862
1,1910,899,481,899,0,0,6756,200,0
3,1916,1344,624,624,0,0,4571,513,720
1,1968,890,890,890,0,0,8450,308,0
1,1941,2133,1528,1225,0,2,10452,312,908
1,1950,1328,768,768,0,0,6000,308,560
3,2003,2392,2392,2392,248,1,13472,968,0
2,2004,2084,956,956,0,0,10142,618,1128
1,1956,1024,1008,1024,0,2,10533,313,0
1,1963,1040,1040,1040,0,0,7500,308,0
0,1961,1800,1800,1800,0,0,8000,0,0
2,1963,1728,1728,1728,0,0,9100,504,0
2,2007,1456,728,728,100,1,9018,400,728
1,1962,864,864,864,0,0,7000,336,0
2,1998,1463,1463,1463,0,0,14753,539,0
3,2006,2172,1063,1071,192,1,14154,947,1101
1,1953,1210,0,1210,208,0,9533,616,0
3,2008,1766,1751,1766,216,2,11778,874,0
1,1954,1056,1056,1056,390,0,9250,260,0
2,1910,1760,1077,981,120,1,10818,648,779
2,1900,1445,676,831,0,0,14235,484,614
2,1954,894,894,894,0,0,9450,400,0
2,1920,1196,684,684,0,0,12354,528,512
1,1920,1738,715,1281,55,1,12513,368,457
3,2003,2200,2200,2200,208,1,15262,685,0
0,1962,1728,1728,1728,0,0,13260,0,0
1,1955,827,0,827,0,1,7200,392,0
2,2004,1948,847,847,100,1,12393,434,1101
3,2008,1254,1254,1254,168,0,10324,810,0
2,2004,848,848,848,140,0,4426,420,0
2,1992,1759,1449,944,150,1,16698,525,815
1,1961,1029,1029,1029,64,0,7943,261,0
1,1938,1374,884,932,64,0,9260,225,442
1,1925,995,960,995,0,0,6120,264,0
2,2008,1652,1600,1652,162,1,5587,482,0
3,2006,2550,1108,1148,120,1,13440,670,1402
2,1969,1336,1288,1336,312,1,9600,502,0
1,1970,1092,546,546,0,0,1533,286,546
2,2006,1394,384,754,100,0,9735,400,640
3,1995,2794,1462,1490,0,1,15138,810,1304
2,1968,2110,2110,2110,0,2,11160,522,0
1,1946,407,407,407,76,0,7311,297,0
2,1936,1466,796,1096,436,1,10800,566,370
2,1916,2134,844,1445,0,0,11888,441,689
3,2004,2473,1143,1143,192,1,9591,852,1330
1,1951,1480,1080,1080,0,1,11100,253,400
2,1977,1212,506,1212,292,1,8471,492,0
3,2008,1694,1694,1694,160,0,10475,776,0
1,1978,1152,1152,1152,0,0,10547,252,0
1,1947,1216,832,832,158,0,8480,336,384
3,2006,1634,1626,1634,0,1,11428,866,0
1,1967,1214,1214,1214,0,1,10355,318,0
1,1920,1513,939,939,24,0,6120,180,574
1,1977,1475,757,925,104,1,2665,336,550
3,1992,2225,1390,1402,198,1,11134,713,823
1,1973,1218,672,672,144,0,1890,264,546
2,1991,1217,1217,1217,0,0,7175,484,0
1,1960,958,958,958,0,0,12772,301,0
1,1963,1068,1059,1068,192,0,8414,264,0
1,1935,1242,583,647,329,1,5707,180,595
0,1920,1406,319,1035,0,0,7920,0,371
3,1998,2385,1066,1108,120,1,10790,600,1277
2,2004,2522,2208,2522,182,1,7296,564,0
2,2006,1250,625,625,0,0,4251,528,625
0,1975,864,864,864,0,0,9350,0,0
1,1972,864,864,864,0,1,15523,338,0
2,1972,1479,725,725,0,0,7472,484,754
0,1971,1218,672,672,201,0,1680,0,546
2,2003,1626,764,764,0,0,2628,474,862
2,1992,1575,1575,1575,0,0,8012,529,0
2,1959,1188,1188,1188,0,0,12160,531,0
1,1958,1524,874,874,0,0,11344,315,650
1,1945,1340,780,816,0,0,6430,440,524
1,1920,1344,672,672,0,0,10690,468,672
0,1938,1053,585,585,42,0,12180,0,468
2,2005,1090,1090,1090,0,0,7024,450,0
2,1976,1456,855,855,87,1,2280,440,601
2,2005,1142,1142,1142,90,0,3010,440,0
2,1975,1040,1040,1040,0,0,4224,499,0
2,2004,1500,1500,1500,192,0,8487,570,0
1,1953,1609,1000,1068,0,0,9525,305,541
2,1931,1774,952,1022,90,2,6120,468,752
2,1953,2259,1809,2259,166,2,21000,450,0
2,1977,1009,995,1009,0,1,9720,576,0
1,1938,1251,827,827,0,0,6900,240,424
2,1934,1176,816,816,112,1,6240,528,0
2,1964,1445,1127,1445,180,1,12095,645,0
1,1949,1523,1067,986,0,1,15600,295,537
2,1967,894,894,894,0,0,9764,450,0
2,1928,784,784,784,0,0,9000,360,0
2,1965,1264,1068,1264,0,1,15300,528,0
3,2008,1641,1641,1641,0,0,14463,885,0
1,1926,1316,644,672,0,1,8969,369,644
3,2003,2696,2846,2696,220,2,14300,958,0
2,1958,2279,585,2279,274,1,19958,461,0
1,1957,1788,1104,1104,120,2,11250,304,684
2,1965,1324,1088,1324,0,1,8658,440,0
2,1900,1627,797,830,192,0,9142,420,797
2,1954,1293,1178,1293,280,0,11027,452,0
2,2005,1844,1844,1844,165,1,10994,620,0
2,2005,1971,1113,1113,0,1,9675,689,858
1,1954,1172,1172,1172,240,0,9525,366,0
3,2003,2690,1765,1804,268,1,16451,795,886
1,1916,952,952,952,0,1,8854,192,0
1,1958,1215,1215,1215,0,0,12400,297,0
3,2006,1939,1095,1095,192,1,10728,1053,844
1,1994,990,990,990,66,0,9757,440,0
1,1906,1469,756,756,57,0,10320,216,713
2,1961,1144,1144,1144,0,0,7875,456,0
3,1925,2640,2171,1392,631,1,22136,1008,1248
3,2007,2574,1482,1482,0,1,9588,868,1092
1,1920,1216,565,565,0,1,5520,355,651
2,2003,1986,847,847,120,1,8396,434,1139
1,1956,1202,1202,1202,0,0,8750,304,0
2,2001,1786,920,920,0,1,11250,608,866
2,2007,1780,920,920,0,1,12852,612,860
2,2000,1512,756,756,0,0,2980,440,756
2,1923,1603,784,819,0,1,9650,599,784
2,2005,1368,1368,1368,132,1,6955,474,0
2,1975,1055,1057,1055,0,1,2280,440,0
3,1998,2006,1982,2006,144,1,11675,938,0
1,1931,1818,1040,1226,0,2,7758,240,592
2,1998,1633,932,932,0,1,11184,460,701
2,2005,1310,1310,1310,0,1,8767,400,0
2,1926,960,850,960,0,0,6978,576,0
2,1989,1982,807,1175,0,1,11287,575,807
2,1998,1465,789,789,0,1,8402,393,676
2,1971,2365,1803,2365,200,2,17597,551,0
2,2000,1630,1630,1630,74,1,9750,451,0
2,1977,1208,1208,1208,198,1,11250,546,0
2,2001,2161,1257,1290,0,1,10400,570,871
2,1982,816,816,816,0,0,6600,816,0
3,2006,1776,1732,1776,0,1,15306,712,0
1,1983,816,816,816,315,0,6490,264,0
0,1920,1027,931,1027,0,1,5400,0,0
2,1937,1131,907,1131,0,0,5925,672,0
0,1895,1991,957,1034,0,0,8250,0,957
1,1920,438,290,438,0,0,8400,246,0
2,2007,1338,1338,1338,0,0,8640,598,0
2,1970,1302,630,630,0,0,2016,440,672
1,1958,792,792,792,0,0,5470,366,0
2,1935,1873,608,983,0,2,9670,786,890
4,1880,2640,1240,1320,181,1,11700,864,1320
3,2007,2161,1582,1610,178,1,10562,789,551
2,1962,1224,0,1224,0,0,9842,462,0
1,1949,1716,768,1148,0,1,11409,281,568
3,2007,1718,1705,1718,208,1,10637,826,0
2,1971,868,768,868,138,0,8425,576,0
2,1970,1277,1277,1277,0,1,10628,526,0
2,1998,1661,1649,1661,0,0,12137,598,0
2,2004,1709,970,970,0,0,2522,380,739
2,1955,864,864,864,0,0,8172,572,0
2,1977,1126,1126,1126,295,1,17400,484,0
0,2006,1143,1143,1143,0,0,7500,0,0
1,1953,1040,1040,1040,0,0,7942,293,0
2,1971,1320,1232,1320,0,1,16500,495,0
0,1910,2256,840,1128,0,0,9045,0,1128
3,1935,3086,666,1308,0,0,21281,1200,1778
0,1925,864,864,864,0,0,5604,0,0
2,2004,1200,600,600,0,0,3215,480,600
3,2007,1818,895,895,196,1,12568,774,923
1,1967,864,864,864,0,0,7130,312,0
2,1969,1851,1851,1851,0,1,11727,506,0
3,2008,2276,2271,2276,0,2,11778,1348,0
2,1910,1432,264,768,270,0,9600,360,664
2,1978,1400,672,672,0,1,7844,440,728
2,2003,1337,1337,1337,0,0,8450,531,0
1,1971,1092,525,525,0,0,1680,264,567
1,1952,1148,980,1148,0,0,6420,308,0
2,1910,1690,560,930,0,0,7200,624,760
1,1958,1632,1240,1632,289,1,9600,338,0
1,1956,882,0,882,0,0,12702,308,0
1,1962,1092,1092,1092,0,1,11616,288,0
2,1994,1657,832,832,144,0,14565,483,825
2,1984,1868,585,1140,268,1,12090,477,728
2,1964,1977,816,1127,0,1,9500,540,850
2,2007,1496,768,768,100,0,15810,572,728
2,2003,1405,1405,1405,136,1,3242,478,0
2,2005,1734,1734,1734,160,0,11645,660,0
3,2003,1944,1896,1944,208,3,12378,708,0
3,2008,1866,1858,1866,0,1,10110,870,0
1,1984,887,864,887,140,0,10447,288,0
3,2010,1856,1856,1856,113,1,11394,834,0
0,1924,784,784,784,0,0,6130,0,0
2,1995,1499,781,795,413,1,12438,473,704
2,1978,1548,804,804,108,1,2364,440,744
1,1955,1393,816,872,121,0,16466,300,521
2,1958,1312,1312,1312,0,1,11355,495,0
2,1984,1621,1208,1621,108,0,14145,440,0
1,1972,987,483,483,0,0,1680,288,504
0,1941,693,693,693,0,0,4118,0,0
1,1959,1357,1019,1357,0,1,11512,312,0
1,1977,907,876,907,0,0,16300,308,0
3,2000,2153,1440,1476,253,2,11050,736,677
0,1958,858,858,858,117,0,7207,0,0
2,2009,1478,1470,1478,0,1,4403,484,0
3,1957,1362,1040,1362,0,1,9450,768,0
1,1966,1228,1228,1228,0,0,8544,271,0
2,1966,1165,1127,1165,0,0,9020,490,0
1,1970,1092,546,546,0,0,1894,286,546
2,2009,1314,1300,1314,135,0,8640,552,0
3,2006,3390,1528,1528,204,1,18062,758,1862
2,2009,1547,756,764,169,0,8640,614,783
1,1977,1304,264,616,141,1,2665,336,688
2,1999,1471,729,742,0,0,3230,440,729
1,1959,960,960,960,144,0,6400,392,0
1,1927,520,520,520,49,0,6324,240,0
1,1932,1520,793,848,0,0,4500,281,672
1,1923,792,624,792,0,0,8520,287,0
2,1962,988,988,988,0,0,9100,624,0
1,1997,1694,569,854,0,1,8314,434,840
2,1994,1895,712,1086,143,1,10832,409,809
2,1999,1804,994,1028,140,1,7500,442,776
2,1962,1537,1319,1537,0,1,8400,462,0
1,1970,987,483,483,0,0,1869,280,504
2,2002,2267,1010,1010,120,1,8068,390,1257
2,1998,1636,952,952,0,1,7500,440,684
2,2009,1212,1212,1212,100,0,10420,460,0
1,1920,1336,637,897,0,0,11040,570,439
2,1963,1796,780,983,0,1,7056,483,813
3,2005,1498,1498,1498,144,1,11645,844,0
3,2004,2443,1158,1158,193,1,10625,744,1285
3,2005,1552,1552,1552,144,0,10084,782,0
1,1947,1284,720,720,0,0,3500,240,564
1,1982,816,816,816,168,0,8314,264,0
1,1918,1426,912,912,0,1,7642,216,514
2,1997,2236,964,993,0,1,13006,642,1243
2,2005,1565,1560,1565,196,1,5911,556,0
2,1996,1491,1491,1491,0,1,7777,571,0
2,2007,1838,1838,1838,154,2,11422,524,0
2,1976,2030,848,1118,0,1,12046,551,912
2,1968,894,894,894,0,1,8724,450,0
2,1977,1285,1243,1285,375,1,9620,473,0
1,1970,630,630,630,0,0,1526,286,0
3,1981,1842,1842,1842,857,1,50271,894,0
1,1962,1269,621,621,0,0,9360,280,648
2,1971,1052,1010,1052,0,0,8816,440,0
1,1915,1647,806,841,0,0,6858,216,806
2,1994,990,990,990,168,0,9750,528,0
2,1920,1167,915,1167,0,1,8731,495,0
2,1985,1732,741,977,192,1,9206,476,755
0,1940,1518,1580,1518,0,2,19550,0,0
0,1975,980,945,980,0,0,9400,0,0
2,1893,2775,1237,1521,105,1,13500,880,1254
2,1996,1661,799,827,158,1,10667,550,834
1,1910,1484,771,866,14,0,10320,264,504
1,1969,1360,1104,1360,160,1,13384,336,0
2,1910,1510,677,833,0,0,9600,720,677
1,1967,936,936,936,405,1,9825,384,0
2,1996,1776,821,821,286,1,9783,443,955
1,1956,1005,1005,1005,0,1,11050,319,0
2,1974,1173,1053,1173,0,2,10625,528,0
2,2005,1220,1220,1220,100,1,3182,397,0
2,1956,1811,1073,1811,0,1,14115,470,0
2,2005,1506,1494,1506,192,1,8251,672,0
1,1972,796,796,796,138,0,7689,336,0
2,1960,1138,1138,1138,0,1,15312,480,0
1,1956,1370,1058,1370,191,1,10000,300,0
2,1988,2060,1151,1164,0,1,10029,521,896
1,1923,1068,1124,1068,0,1,6120,288,0
1,1940,1717,901,1125,0,1,12400,410,592
2,1968,1978,832,1098,0,1,9900,486,880
2,1900,1428,712,848,264,0,6451,576,580
2,1984,1003,1003,1003,120,0,7937,588,0
2,1977,1285,660,1285,138,1,8197,528,0
1,1953,1008,1008,1008,0,0,8923,240,0
2,1974,1792,896,896,0,0,9000,480,896
1,1968,1160,1113,1160,81,0,17979,257,0
2,1954,988,988,988,0,0,21750,520,0
2,1996,2037,672,1302,100,1,10541,472,735
2,1972,1610,1124,1610,202,1,11358,515,0
2,2002,1444,1431,1444,144,0,10739,577,0
0,1961,1800,1800,1800,0,0,8513,0,0
3,1990,2196,2158,2196,84,1,14684,701,0
1,1945,747,747,747,0,0,4608,220,0
3,2005,1958,1026,1026,154,1,10625,936,932
2,1957,1478,1478,1478,114,2,8400,442,0
2,1939,1954,798,1137,0,2,15660,431,817
2,1984,889,864,889,0,0,12395,484,0
2,2005,1553,756,756,0,0,8125,615,797
2,1980,1556,716,716,161,1,1950,452,840
2,1976,1025,1015,1025,127,1,8660,370,0
2,1910,2019,728,1136,509,0,11414,532,883
2,1956,1074,894,1074,0,1,7450,396,0
2,1939,1118,793,793,0,1,7800,410,325
3,2000,2052,1107,1040,210,1,10125,642,1012
1,1956,928,928,928,261,0,13300,252,0
0,1925,1601,936,936,0,0,7288,0,665
3,2006,1574,1574,1574,144,1,11957,824,0
2,1969,1258,1198,1258,120,0,12900,400,0
3,1995,3627,1930,1831,361,1,35760,807,1796
2,1966,2087,832,976,133,0,12205,444,1111
2,2005,1270,1270,1270,0,0,7242,524,0
1,1920,1480,972,1044,0,0,5400,207,0
2,1967,1342,1372,1342,0,1,9790,457,0
2,1958,1344,819,1344,0,1,14375,525,0
3,2009,2334,1590,1627,144,1,12858,751,707
2,1952,1044,540,1044,0,0,8712,504,0
1,1931,1367,884,959,0,1,6240,560,408
1,1959,1040,1040,1040,0,0,7500,286,0
1,1916,1690,815,815,0,1,8850,225,875
1,1967,1052,1052,1052,0,1,11625,668,0
2,1975,1621,1621,1621,0,2,9373,478,0
2,1905,1912,482,1221,0,1,10800,672,691
2,2006,1301,1293,1301,216,1,7200,572,0
2,2003,1992,1053,1053,140,1,9375,648,939
3,2006,1746,698,698,0,1,9729,350,1048
2,1997,1604,926,926,0,1,8702,470,678
2,1935,3672,1836,1836,684,2,19800,836,1836
3,2007,2084,2078,2084,188,1,14803,1220,0
0,1912,2229,755,929,0,0,5520,0,929
1,1927,1666,1204,1204,0,0,5160,384,462
0,1946,3086,1598,1636,122,1,18030,0,971
2,1970,882,882,882,240,0,8400,525,0
0,1985,833,833,833,0,0,8780,0,0
2,1974,1494,1208,1494,296,2,15410,461,0
2,2006,1342,1342,1342,0,1,6240,550,0
3,2006,1718,1700,1718,216,1,12456,786,0
1,1930,713,713,713,0,0,10410,371,0
2,1960,1252,1602,1252,409,1,13500,564,0
2,1972,894,894,894,256,0,9800,552,0
3,2006,1802,1802,1802,158,1,13615,843,0
1,1948,972,972,972,0,1,8000,240,0
2,1993,2200,812,1101,168,1,14171,453,1099
2,2000,1690,915,940,0,1,9487,442,750
0,2007,1120,1120,1120,0,0,8402,0,0
2,1998,1924,1086,1086,208,1,12011,592,838
2,2006,1250,625,625,0,0,4017,625,625
1,1939,1132,608,608,0,0,6000,240,524
2,1998,1425,1425,1425,0,0,8685,591,0
2,2003,1948,847,847,0,1,7875,434,1101
2,1978,1441,855,855,28,1,2289,440,586
3,2007,2464,2418,2464,358,1,13693,650,0
1,1922,498,498,498,0,0,8088,216,0
2,1968,1040,1040,1040,188,0,7476,686,0
1,1953,1319,608,1319,66,0,10634,270,0
2,1976,2499,392,1487,0,1,9600,527,1012
3,1999,2599,1393,1422,668,1,14774,779,1177
1,1948,1079,570,617,135,1,5190,249,462
2,1960,1175,1175,1175,0,0,7635,484,0
1,1947,1531,756,1169,0,1,9350,209,0
2,1926,747,600,747,0,0,5825,528,0
1,1920,1245,1008,1060,0,0,8239,315,185
2,1968,1392,1392,1392,0,2,13560,576,0
0,2004,1158,1158,1158,0,0,7500,0,0
4,1993,1802,946,964,450,1,12361,1017,838
2,2005,1721,1721,1721,168,0,9254,554,0
2,1920,1128,698,698,30,0,7500,528,430
3,2006,1976,1976,1976,250,1,14977,908,0
2,2006,1220,1199,1220,105,0,7406,632,0
1,1955,768,768,768,0,1,8172,355,0
0,1910,968,600,600,0,0,5925,0,368
2,1976,1444,1444,1444,0,1,10400,473,0
2,2002,2031,1128,1128,0,1,9473,577,903
2,1949,1126,0,1126,0,0,8777,520,0
2,1923,832,678,832,0,1,9656,780,0
1,1900,720,448,448,0,0,7008,280,272
2,2007,1234,1234,1234,0,0,11049,484,0
2,1985,1298,1298,1298,165,1,11200,403,0
5,1925,1072,1072,1072,0,0,8635,1184,0
3,2005,2000,1910,2000,351,2,18261,722,0
3,2006,2589,1738,1738,0,1,16387,831,851
2,1972,768,768,768,58,0,8445,396,0
0,1912,1716,780,936,0,0,5687,0,780
2,1948,2320,0,1547,120,1,14762,672,720
3,2005,1922,1922,1922,178,1,14157,676,0
2,1964,1350,1248,1350,176,0,9020,520,0
3,2006,1588,1588,1588,144,1,10000,825,0
2,1963,1000,1000,1000,238,2,13050,575,0
2,1962,2486,1595,1611,0,1,33120,576,875
1,1961,888,920,888,0,0,8700,240,0
2,1961,1313,1313,1313,172,1,9350,610,0
2,1976,2898,1565,2898,0,1,15498,665,0
2,1953,1152,1152,1152,0,0,9373,636,0
0,1922,796,796,796,0,0,3636,0,0
2,2004,1269,1256,1269,146,1,3182,430,0
2,1961,988,988,988,0,0,9945,572,0
1,1937,1938,942,1265,0,1,11700,240,673
2,1980,2044,738,1277,28,1,10400,489,767
2,1999,1452,691,713,0,0,3768,506,739
2,1976,1370,1090,1370,0,1,10400,479,0
1,1953,1057,1057,1057,0,0,7922,246,0
1,1954,992,381,992,60,0,8842,319,0
1,1955,1150,1078,1150,0,0,9600,288,0
2,2004,1708,976,976,0,0,3363,380,732
2,2006,1550,1092,1112,0,0,8125,438,438
1,1900,1367,861,961,0,0,8405,384,406
1,1934,1660,715,849,0,1,11988,240,811
2,2003,1390,1390,1390,0,0,8810,545,0
2,2002,2169,1284,1284,192,1,9375,647,885
1,1948,1633,1027,1027,0,1,11851,240,606
1,1901,1173,592,933,0,0,5680,240,240
0,1916,1928,686,948,0,0,7082,0,980
2,2004,1414,1375,1414,144,1,3072,398,0
1,1925,1015,768,1015,0,0,6120,450,0
2,2006,1660,1660,1660,322,1,10182,500,0
1,1954,1278,854,854,0,0,7200,240,424
4,1953,2034,0,2034,483,0,43500,1041,0
1,1910,1049,356,671,0,0,5150,195,378
2,2004,1391,1391,1391,156,0,4282,530,0
2,2006,1604,1604,1604,123,1,8814,660,0
1,1910,1984,1242,1242,64,0,8094,360,742
2,2007,1358,1350,1358,192,1,7301,484,0
2,1938,1409,861,861,225,1,6240,528,548
2,1890,2495,1313,1313,0,1,10800,342,1182
1,1925,572,572,572,0,0,10200,200,0
2,1961,999,944,999,144,0,12122,588,0
3,1994,4316,2444,2444,382,2,21535,832,1872
3,1949,2002,1001,1001,0,0,6270,871,1001
2,2004,1158,1158,1158,0,0,13072,576,0
2,1955,1056,1056,1056,264,0,34650,572,0
1,1921,1107,629,727,0,0,9140,625,380
1,1924,1296,1107,1296,0,1,4853,260,0
1,1962,912,912,912,0,0,7150,252,0
2,1971,1587,1587,1587,0,1,10667,525,0
2,1987,1501,1501,1501,240,2,4054,512,0
2,1980,1032,516,516,279,1,1733,452,516
2,2007,1476,738,738,0,0,8145,552,738
1,1905,1376,738,714,0,0,7614,216,662
1,1915,1396,698,698,0,0,8730,384,698
2,2006,1432,1422,1432,297,1,9139,492,0
2,2005,1358,1358,1358,192,1,6904,484,0
2,1992,1482,384,812,100,1,9125,392,670
2,1964,1921,1921,1921,0,0,11136,576,0
2,1929,1517,792,792,0,2,11435,400,725
2,2007,1710,1710,1710,156,1,8118,557,0
2,2006,1492,738,738,0,0,10237,440,754
2,1966,1120,864,1120,0,1,10710,656,0
1,1956,1337,832,832,0,0,8382,263,505
1,1962,894,894,894,0,0,6600,308,0
2,2009,1508,1508,1508,0,2,17485,572,0
2,1960,1478,1478,1478,0,2,17600,498,0
2,1900,1416,780,940,0,0,9600,400,476
2,2006,1554,1554,1554,156,1,4590,627,0
3,2006,1531,1504,1531,184,1,10872,700,0
1,1940,672,672,672,0,0,4800,256,0
2,1978,1026,940,1026,0,0,10970,576,0
0,1905,1540,572,884,240,0,6000,0,656
2,1995,1995,930,950,275,1,11250,610,1045
0,1960,1556,1556,1556,0,0,8512,0,0
1,1973,988,462,526,0,1,1596,297,462
0,2007,1092,1092,1092,0,0,9278,0,0
1,1968,2142,896,1182,0,1,13000,509,960
2,1959,1472,0,1472,0,1,11650,484,0
2,2006,1496,654,664,100,1,17104,426,832
3,2006,2576,1234,1264,324,1,12438,666,1312
2,2008,5642,6110,4692,214,3,63887,1418,950
2,1976,1935,793,1142,0,1,12384,550,793
1,1959,1206,1206,1206,0,0,10725,312,0
1,1949,1382,0,1382,0,1,11800,384,0
2,1960,1429,1144,1429,216,2,14585,572,0
2,1978,1226,1226,1226,133,1,3876,484,0
2,1972,875,385,875,352,0,7200,728,0
3,2003,2668,1572,1572,400,2,13688,726,1096
2,1976,1117,1029,1117,144,1,7819,672,0
2,1957,1803,1134,1803,0,1,13125,484,0
2,1980,1036,1036,1036,133,1,3640,484,0
2,1999,1479,1468,1479,120,0,9382,577,0
2,1993,1879,1079,1079,400,1,10560,473,800
1,1971,874,864,874,0,0,6953,352,0
2,1960,2274,1105,1105,0,0,11600,480,1169
1,1972,780,780,780,196,0,7200,352,0
2,2000,1800,982,1007,100,1,8123,463,793
1,1939,1465,992,992,0,2,10164,240,473
2,1956,1898,1898,1898,0,2,26073,484,0
2,1977,2288,908,1316,321,2,13774,520,972
2,2003,1509,783,807,0,1,7875,393,702
3,2007,1600,1566,1600,0,1,14230,890,0
3,1993,3500,1733,1933,870,1,17242,959,1567
0,1922,864,864,864,0,0,4060,0,0
1,1956,968,0,968,0,0,8626,331,0
2,1979,1930,780,1085,192,1,11339,481,845
2,1976,2715,1142,1175,0,2,8963,831,1540
3,2004,2000,2000,2000,168,0,10386,888,0
1,1955,1098,1098,1098,0,0,7390,260,0
2,1996,1720,1720,1720,240,1,10593,527,0
1,1969,1096,1096,1096,240,0,15870,299,0
2,1978,1601,1271,1601,0,1,11880,478,0
2,2000,1892,982,1008,108,1,8220,431,884
2,1999,1790,873,882,0,0,9179,588,908
2,1900,2168,760,928,467,0,8660,576,928
2,1967,1829,1829,1829,0,0,10456,535,0
1,1955,1163,1162,1163,142,0,5820,220,0
2,2006,1342,1342,1342,0,1,6240,550,0
3,2003,2470,2535,2470,154,2,12720,789,0
2,2002,1861,916,920,146,0,13450,492,941
2,1997,1494,1479,1494,168,0,9236,576,0
3,2003,2283,1008,1008,120,1,11792,632,1275
0,1940,1306,728,1306,263,0,5350,0,0
4,2000,2787,1168,1168,312,2,11855,820,1619
2,2006,1550,1550,1550,0,0,5330,528,0
1,1954,1063,1056,1063,0,0,9920,280,0
1,1972,1302,630,630,185,0,1680,264,672
1,1920,864,592,432,0,0,9000,216,432
1,1964,1251,1251,1251,0,2,8800,461,0
2,1910,1436,676,760,147,0,8777,528,676
2,1965,1986,768,1186,0,3,13600,486,800
2,1999,1755,840,840,176,1,9468,530,915
1,1959,882,0,882,0,0,8339,294,0
1,1966,912,912,912,204,0,8169,315,0
3,2006,2828,1466,1466,125,1,9965,1052,1362
1,1920,1450,624,730,0,0,5350,288,720
2,2005,1536,768,768,100,1,10237,400,768
2,1999,2322,1037,1037,144,1,12460,400,1285
2,1967,1334,1334,1334,0,0,10140,477,0
2,1979,1625,1625,1625,136,1,23580,576,0
3,2006,2076,2076,2076,216,1,13891,850,0
2,1965,1073,1073,1073,0,0,10289,515,0
1,1940,919,600,600,0,0,6001,231,319
2,1991,1595,1582,1595,0,0,11070,672,0
1,1956,1073,1073,1073,0,0,9571,340,0
2,1995,2090,1220,1220,0,1,10000,556,870
2,1968,1295,1295,1295,0,0,11700,528,0
1,1954,1089,1089,1089,328,1,7440,252,0
0,1931,774,544,774,0,0,4270,0,0
2,1977,1069,1069,1069,0,1,4043,440,0
2,1978,1110,1097,1110,303,1,9101,602,0
0,1920,1452,736,736,0,0,4456,0,716
2,1958,1560,1560,1560,0,0,8078,484,0
3,2006,1258,1258,1258,144,1,3922,648,0
2,1996,1636,916,916,168,1,15038,386,720
2,1999,1983,978,1005,0,1,10762,490,978
2,1948,1325,409,1325,0,1,17541,576,0
2,1997,1525,813,813,421,1,8238,400,712
0,1930,1200,780,780,0,0,8155,0,420
2,1960,1560,1560,1560,0,3,25485,580,0
0,1994,990,990,990,0,0,8070,0,0
0,1872,2358,684,938,0,0,5250,0,1215
0,1971,858,858,858,0,0,8125,0,0
2,2006,1456,728,728,0,1,11103,440,728
1,1955,1056,1056,1056,0,0,13600,300,0
2,2004,1548,1365,1548,143,1,3072,388,0
3,2003,2046,998,1006,320,1,10625,871,1040
2,1971,864,864,864,216,0,10500,576,0
2,2004,1646,1594,1646,128,1,3842,482,0
1,1957,1236,1070,1236,0,1,10011,447,0
2,1978,2050,832,1154,192,1,13250,529,896
2,2001,1789,858,872,0,1,10646,546,917
2,2006,1294,1286,1294,168,1,6762,662,0
2,2003,1114,1114,1114,0,0,13695,576,0
2,1979,1586,1362,1586,192,1,17043,435,0
2,2007,1232,1232,1232,132,0,7314,632,0
1,1962,999,925,999,150,0,10205,300,0
2,1972,864,864,864,155,0,7200,576,0
3,2006,2945,1410,1426,192,1,13682,641,1519
2,1991,2417,1288,1301,127,1,16059,462,1116
3,2006,2640,2036,2036,0,1,13162,792,604
2,2005,1964,1100,1116,200,1,12447,760,848
1,1915,1605,840,840,0,0,5790,379,765
1,1920,1077,961,1077,0,0,8967,338,0
1,1959,1150,1150,1150,0,0,7945,300,0
1,1948,936,624,624,0,0,6956,265,312
2,2007,1340,1340,1340,100,0,8899,396,0
2,1926,1316,750,960,0,0,8550,576,356
1,1968,898,833,898,143,0,8400,326,0
2,2005,1490,745,745,36,1,8918,392,745
1,1921,1073,1073,1073,0,0,5400,326,0
0,1915,1526,1013,1013,0,0,8470,0,0
2,2005,1456,728,728,0,1,10237,390,728
2,1920,985,576,985,0,0,7898,676,0
2,1976,1044,960,1044,228,1,6285,528,0
3,2007,1702,1702,1702,0,1,10130,844,0
2,1998,2452,1028,1210,208,1,16226,683,1242
2,1971,1670,825,845,0,0,13355,464,825
2,1998,1204,1204,1204,0,0,4500,412,0
1,1954,984,936,984,0,0,6390,280,0
1,1942,976,976,976,160,0,7288,215,0
2,1978,1034,450,1034,311,1,7703,504,0
2,2004,1709,970,970,0,0,2522,380,739
3,2000,2172,1519,1533,162,1,11000,687,639
2,1962,1057,1057,1057,0,0,7420,576,0
2,2006,1370,1370,1370,120,1,6442,484,0
2,1990,2329,1475,1532,192,1,11839,514,797
1,1960,1100,1100,1100,355,1,12493,312,0
2,2003,1668,840,840,144,0,11317,500,828
2,1991,1294,1278,1294,112,0,7153,496,0
2,1962,1283,931,1283,0,0,7763,506,0
2,2001,1788,1753,1788,202,1,11838,522,0
2,1968,1044,912,1044,200,1,10180,372,0
1,1959,1041,1041,1041,224,0,9600,270,0
2,1978,1981,1117,1117,336,1,17082,522,864
1,1959,864,864,864,0,0,9100,300,0
1,2008,1133,192,1133,0,0,9836,308,0
1,1950,1521,910,910,199,0,12144,597,611
2,2000,1848,975,975,280,1,7379,592,873
2,2007,1358,1350,1358,192,1,10307,484,0
1,1924,1691,1026,1026,0,1,5000,308,665
2,2005,1166,856,1166,212,0,9587,400,0
3,2003,1792,1792,1792,206,1,11846,874,0
1,1962,912,912,912,140,0,12968,352,0
2,1998,1796,794,882,0,0,9531,546,914
1,1967,980,980,980,68,0,9750,384,0
2,2000,2054,992,1022,24,1,12224,390,1032
1,1957,845,0,845,186,0,11500,290,0
2,1988,2062,1157,1180,60,1,14364,454,882
1,1958,1601,533,1021,280,0,13825,300,580
2,1927,756,660,756,80,0,9259,440,0
2,1970,864,864,864,210,0,7038,576,0
2,1957,1236,912,1236,0,0,7407,923,0
2,1999,1675,1666,1675,165,0,7915,435,0
0,1978,1040,1040,1040,0,0,8430,0,0
1,1920,967,967,967,0,1,3153,180,0
3,2008,2007,1017,1026,168,1,11003,812,981
2,2004,1143,1143,1143,0,1,3628,588,0
1,1958,1142,160,1142,0,1,9000,384,0
3,1918,2624,1370,1370,0,1,22420,864,1254
1,1920,1192,596,596,0,0,6402,189,596
2,1986,1453,1453,1453,0,1,5271,445,0
2,1999,1764,850,886,120,1,11690,560,878
2,1954,1906,1310,1906,0,2,17500,576,0
2,1898,2138,849,1075,40,0,8100,360,1063
1,1978,864,864,864,0,0,7000,336,0
1,1950,841,721,841,250,0,8400,294,0
2,1967,2640,932,1271,0,1,10400,515,1369
2,1956,1437,1188,1437,304,1,14175,576,0
2,1996,2125,1064,1064,168,2,10990,576,1061
1,1959,1143,1143,1143,0,0,8050,308,0
1,1958,808,808,808,143,0,5175,308,0
2,1963,816,816,816,106,0,8472,516,0
2,1930,1573,1078,1128,0,1,6240,360,445
0,1890,1544,925,1000,231,0,14190,0,544
1,1922,1022,1022,1022,0,1,4480,184,0
2,1992,1731,836,844,307,0,9370,462,887
2,1955,1360,384,1360,0,1,7134,572,0
2,2005,1190,1169,1190,100,0,8769,578,0
1,1969,1176,1176,1176,0,0,16133,360,0
2,2000,1690,924,948,100,1,8063,463,742
3,1994,2063,2024,2063,182,2,10750,815,0
2,1970,1422,925,1422,252,0,9457,576,0
3,2005,1546,1546,1546,144,0,11750,796,0
1,1973,945,945,945,174,1,2394,253,0
2,1996,1716,880,909,0,1,8750,512,807
2,2005,1306,1306,1306,170,1,5381,624,0
2,1992,1593,808,808,342,1,9636,389,785
2,1969,1427,1427,1427,0,0,11104,516,0
2,1890,2268,346,1157,0,0,9000,624,1111
4,1993,1440,1344,1440,288,0,9069,920,0
2,2000,1889,982,1008,0,1,8658,431,881
2,2002,1419,408,779,120,1,7750,527,640
2,2005,1072,547,1072,0,0,3675,525,0
2,1991,1472,384,802,164,1,10784,402,670
2,2007,1869,1869,1869,210,1,7820,617,0
2,1970,864,864,864,0,0,8120,463,0
2,1885,2290,777,1246,0,0,11340,560,1044
2,1980,1229,561,561,154,1,1612,462,668
1,1930,816,816,816,0,0,5890,432,0
2,1976,1671,1426,1671,280,1,16280,550,0
2,1993,1199,1199,1199,0,0,7892,530,0
2,1924,1301,1145,1301,0,0,6911,440,0
2,1961,1453,1453,1453,0,1,10573,530,0
3,1957,1797,1617,1797,0,1,11765,963,0
0,1954,1124,0,1124,0,1,8335,0,0
2,1965,1214,1214,1214,0,0,9170,461,0
1,1946,704,560,704,0,0,4280,220,0
3,2006,1977,982,982,240,0,9605,574,995
2,2000,1349,1349,1349,120,0,8450,539,0
1,1915,1456,728,728,0,0,6000,308,728
2,2006,1335,1335,1335,0,0,9000,575,0
3,2006,1828,1298,1298,0,0,10732,876,530
3,2007,2290,2320,2290,192,1,17169,1174,0
2,1966,1093,1093,1093,224,1,10738,484,0
2,1929,1344,672,672,0,1,5700,456,672
0,1971,796,796,796,129,0,6723,0,0
2,1971,1078,1078,1078,0,1,12537,500,0
2,1975,1558,864,1558,140,0,14330,440,0
1,1946,1242,484,1242,0,0,17808,336,0
2,1972,1790,732,1012,148,1,10400,484,778
2,1997,1604,926,926,0,1,10839,470,678
2,1967,1620,1620,1620,0,1,15387,578,0
3,2004,1780,1780,1780,144,1,14828,816,0
2,1975,1193,1176,1193,40,1,11050,506,0
2,2005,1408,734,734,0,0,7023,489,674
0,1945,866,686,866,58,0,3880,0,0
3,2005,2028,1868,2028,326,2,11443,880,0
1,1968,952,952,952,0,0,8300,288,0
2,1915,2180,1138,1138,0,1,10320,720,1042
1,1956,1104,1104,1104,0,0,10425,384,0
2,1920,1362,611,751,0,0,6155,502,611
2,1936,1135,560,575,256,0,7200,576,560
2,2007,2610,1184,1184,208,1,9000,550,1426
1,1930,1098,531,567,0,1,4000,216,531
2,1958,1650,1632,1650,0,2,50102,518,0
2,2003,1557,1374,1557,143,1,3196,420,0
2,1920,1118,648,734,0,0,4400,440,384
2,1948,1122,924,1122,0,0,12000,528,0
2,1963,1395,1395,1395,657,1,9760,440,0
3,1995,2726,1342,1358,307,1,10019,725,1368
1,1926,919,894,919,0,0,7000,195,0
3,2003,2452,2452,2452,0,1,15274,886,0
2,2003,1405,1405,1405,148,1,3136,478,0
1,1957,1244,1244,1244,0,2,11988,336,0
3,2004,2373,1052,1052,120,1,11631,632,1321
2,2006,1492,738,738,100,0,9073,440,754
2,1930,768,768,768,0,0,6291,440,0
2,1997,1786,824,905,0,0,9337,684,881
1,1924,1310,617,865,0,0,7000,398,445
2,2009,1224,612,612,0,0,3000,528,612
2,1953,910,105,910,196,0,8892,414,0
3,2004,2468,1136,1136,184,1,12099,872,1332
2,1954,1363,1385,1363,81,2,39104,439,0
2,1995,1616,1595,1616,237,1,5389,608,0
2,1994,1850,973,979,168,1,29959,467,871
2,1937,1176,698,786,210,0,6000,624,390
1,1956,1509,1509,1509,158,1,9571,322,0
1,1996,1097,1097,1097,306,0,16561,242,0
2,2005,1208,1208,1208,105,0,7488,632,0
2,1978,2784,1392,1392,0,2,16692,564,1392
1,1936,879,830,879,0,0,5220,180,0
2,1992,2295,1095,1166,0,1,13346,590,1129
2,1923,1848,833,1053,0,1,13053,370,795
2,1990,2514,1216,1298,0,0,11170,693,1216
1,1967,1656,624,1092,0,1,6000,288,564
2,1986,1400,676,698,0,0,10274,465,702
2,1999,1651,831,873,0,1,8390,450,778
1,1930,1324,741,741,0,0,6120,180,583
2,2007,1761,874,874,144,0,10207,578,887
2,1973,1656,1656,1656,0,0,9246,506,0
2,1981,1422,1422,1422,276,1,12090,576,0
2,2006,1625,1573,1625,123,1,5568,495,0
0,1971,864,864,864,0,1,10500,0,0
1,1940,1090,720,760,0,0,6000,240,330
3,2005,2206,1090,1117,148,1,13975,670,1089
2,2006,1442,352,712,100,0,9802,400,730
3,2005,2097,2077,2097,192,1,20896,1134,0
0,1910,1447,801,801,80,0,10134,0,646
2,1988,1412,1392,1412,0,1,11457,576,0
1,1984,923,876,923,362,0,6951,264,0
3,2003,2385,1317,1217,192,1,14277,818,1168
1,1982,845,845,845,0,0,6600,264,0
1,1910,1330,396,665,0,0,7518,390,665
1,1935,1573,884,989,0,0,6120,240,584
3,2007,1726,1726,1726,171,1,9416,786,0
2,2008,1256,1145,1256,0,1,4217,641,0
2,2003,1553,1553,1553,192,0,8736,588,0
3,2002,1712,1712,1712,218,1,16770,701,0
2,1939,2009,989,1245,0,1,6240,400,764
2,1912,759,451,759,40,0,10320,576,0
3,1996,2398,1379,1383,239,1,11787,834,1015
2,2003,1656,746,760,178,1,6931,397,896
1,1921,1298,651,759,216,1,6821,240,539
3,2002,1922,1922,1922,201,1,11305,692,0
2,1998,1724,880,880,120,0,8924,527,844
1,1900,1290,554,736,38,0,5870,200,554
1,1913,694,440,694,0,1,4280,352,0
1,1945,1487,735,798,0,1,8741,220,689
2,1997,1384,384,754,0,1,8872,390,630
2,1976,1324,1228,1324,407,1,8991,585,0
2,1975,1875,675,1109,48,1,10530,485,766
2,1954,1482,954,1482,0,1,16012,609,0
2,1964,2154,845,845,0,1,8800,539,1309
3,1999,1852,1004,1004,224,2,9066,660,848
2,1976,1523,1193,1523,0,1,11361,478,0
1,1920,1012,816,1012,121,0,9800,429,0
1,1956,1560,1150,1560,0,1,11767,313,0
1,1958,988,988,988,0,0,13587,264,0
1,1925,1060,756,916,0,1,6854,308,144
3,2005,1960,1728,1960,172,2,13618,714,0
0,1949,1192,720,720,0,0,10800,0,472
1,1951,884,884,884,0,0,15428,270,0
1,1930,1358,687,687,0,1,3600,336,671
2,1970,1657,1657,1657,0,1,12155,484,0
2,2002,2290,1128,1149,0,1,11250,779,1141
3,2008,2042,2042,2042,0,1,12704,1390,0
1,1965,965,828,965,421,0,7800,300,0
2,2006,1564,1546,1564,132,1,8298,502,0
2,2005,2064,1074,1074,0,1,13128,527,990
2,1925,764,680,764,0,0,5232,504,0
2,2001,1792,963,963,0,1,12435,564,829
1,1925,816,816,816,168,0,11672,210,0
3,2009,1968,774,774,0,1,12003,680,1194
3,2008,2402,3094,2402,0,2,15431,672,0
1,1950,932,932,932,0,1,8280,306,0
2,1960,1065,1065,1065,74,0,8892,461,0
1,1984,752,744,752,353,0,7175,264,0
2,1993,2075,1148,1091,235,1,10530,473,984
3,2004,1782,1782,1782,99,2,16870,932,0
2,1974,1026,970,1026,193,1,8410,528,0
1,1942,1282,672,778,0,0,4484,240,504
1,1950,1668,856,1112,0,0,9600,271,556
2,1994,1626,1602,1626,424,1,9938,534,0
2,2007,1419,1419,1419,140,1,8089,567,0
2,2005,1596,784,784,144,0,9316,610,812
1,1952,1008,1008,1008,0,0,12778,280,0
2,1917,2058,735,1134,0,1,9600,396,924
2,2006,1412,616,616,0,1,8499,432,796
1,1953,1036,1036,1036,120,0,7584,312,0
1,1935,1032,0,1032,0,1,8250,260,0
2,1970,864,864,864,96,0,6960,660,0
2,1998,1604,926,926,360,1,9978,470,678
1,1963,1380,1380,1380,0,0,10143,364,0
2,1963,925,925,925,203,0,8638,484,0
1,1937,906,348,453,0,0,4882,231,453
3,1997,1838,1838,1838,160,0,10126,721,0
2,1998,1337,1237,1337,0,0,4500,405,0
3,1915,1214,672,694,216,0,10410,936,520
2,1975,969,969,969,0,0,10356,440,0
3,2008,2296,1722,1728,382,1,13478,842,568
2,1999,1458,729,729,0,1,3230,440,729
2,1999,1337,1405,1337,203,1,5858,511,0
1,1979,918,918,918,28,1,7892,264,0
2,1974,1389,1389,1389,240,1,10010,418,0
1,1926,1224,818,818,0,0,3950,210,406
2,1948,1559,1559,1559,0,0,8100,812,0
1,1960,1144,1144,1144,0,1,9100,336,0
2,2001,1338,1338,1338,0,0,4920,582,0
3,2007,2656,1934,1943,268,1,13641,1040,713
1,1919,1636,818,818,0,1,9399,288,818
2,1974,1877,1084,1084,0,1,8000,488,793
2,1966,1320,1164,1320,160,2,11777,564,0
2,1992,1603,761,810,0,0,7153,484,793
2,1890,1869,1088,1188,48,0,8820,456,561
2,1940,1215,720,720,0,0,7000,720,495
0,1970,1092,546,546,200,0,1476,0,546
3,2006,2643,2153,2069,414,1,13693,694,574
0,1935,729,270,729,0,0,4130,0,0
1,1951,1091,1091,1091,66,1,7801,344,0
2,1996,2013,1117,1127,180,1,9920,455,886
1,1977,1268,1268,1268,173,0,9286,252,0
1,1955,972,972,972,0,0,10895,305,0
2,1950,1067,1067,1067,290,0,9600,436,0
2,1952,733,0,733,0,0,14584,487,0
2,2005,1752,1752,1752,196,1,7658,576,0
2,2004,1710,1710,1710,100,1,12118,550,0
2,1999,1430,384,774,0,1,7848,410,656
2,1992,883,828,883,100,1,7669,698,0
2,1961,1155,1109,1155,192,0,11782,576,0
3,2006,1656,1656,1656,0,0,11096,826,0
2,1977,1279,1196,1279,238,2,10125,473,0
1,1939,1342,739,874,0,1,6000,240,468
1,1940,1302,680,798,0,2,6960,224,504
2,1972,1181,1138,1181,0,0,10012,588,0
2,2005,1367,1367,1367,0,1,12304,484,0
2,1964,1582,1624,1582,168,0,36500,390,0
2,2004,1709,970,970,0,0,2522,380,739
1,1941,1288,824,824,0,0,6191,240,464
2,2001,1665,810,810,0,0,8400,528,855
3,2007,1689,1689,1689,0,0,9849,954,0
1,1940,1750,983,983,245,0,12508,423,767
1,1963,864,864,864,0,0,6360,276,0
2,2006,1330,1330,1330,0,1,8334,437,0
2,2002,1725,840,840,0,0,8749,550,885
2,1993,1744,996,1014,370,0,9453,457,730
1,1925,1236,768,788,0,1,7006,384,448
1,1920,835,458,835,0,0,10625,366,0
2,2004,1646,1594,1646,128,1,3842,525,0
1,1920,1317,649,649,0,0,8500,250,668
2,1975,1533,1533,1533,200,2,70761,576,0
2,1981,1226,1226,1226,133,2,3782,484,0
2,2006,1326,1326,1326,100,0,11660,427,0
0,1920,1198,901,1088,0,0,5586,0,110
2,2006,1460,1460,1460,0,1,10037,480,0
2,2005,1223,600,520,0,0,2544,480,623
1,1922,1180,700,1180,0,1,11600,252,0
2,1995,2061,1070,1094,296,1,9085,647,967
2,2000,1671,959,959,0,1,10852,472,712
1,1972,987,483,483,0,1,1680,288,504
2,1997,1608,945,945,252,1,10179,470,663
2,2005,1536,768,768,0,0,9045,400,768
2,2002,1358,1348,1358,68,1,11088,418,0
2,1993,1775,740,1006,234,1,9317,425,769
2,1957,1073,1073,1073,0,0,6565,720,0
3,1946,1499,904,904,0,1,9000,869,595
2,2001,1337,1337,1337,136,1,4113,511,0
1,1956,1375,1240,1375,0,1,14175,323,0
2,1997,1511,802,802,95,1,11207,413,709
3,2010,1418,1642,1418,160,1,12853,852,0
1,1962,1207,1135,1207,0,0,9510,264,0
3,2007,1555,1373,1555,143,1,3684,660,0
2,1945,998,0,998,0,0,9000,460,0
2,2005,1561,1561,1561,203,1,7313,556,0
2,1923,1576,1324,1072,0,1,21384,528,504
0,1922,2128,1040,1088,0,0,3000,0,1040
2,1965,2140,744,825,0,1,8970,549,1315
2,1960,1224,1224,1224,474,1,20000,576,0
3,2005,2490,2458,2490,70,2,11128,795,0
3,1998,2475,1629,1645,23,1,17433,962,830
2,1958,864,864,864,0,0,9100,624,0
2,1980,1686,1686,1686,384,1,10240,612,0
2,2002,1720,840,840,138,1,8010,400,880
2,2005,1362,1362,1362,192,1,6289,460,0
2,1961,1773,1313,1773,355,2,10800,418,0
2,1994,2687,2062,2079,168,0,13108,618,608
2,1980,1056,1056,1056,264,0,6979,576,0
2,2005,1132,1132,1132,252,0,7024,451,0
1,1972,1092,546,546,0,0,1484,253,546
3,2003,1589,1406,1589,143,1,3621,630,0
2,1964,1440,720,720,0,1,9350,480,720
2,1910,1232,616,616,280,0,4571,480,616
2,2004,1515,789,813,0,1,9024,393,702
1,1925,1472,702,842,0,0,9600,250,630
2,1980,2362,2002,2362,180,1,12000,546,0
2,2004,2466,1580,1580,159,1,11143,610,886
0,1920,1701,600,1101,0,0,7627,0,600
3,2000,2198,1145,1145,192,1,14260,836,1053
2,1997,1682,1664,1682,0,1,6264,528,0
2,1964,1486,1486,1486,0,0,9937,480,0
2,2000,1874,1058,1058,0,1,7500,588,816
2,1974,1322,855,855,260,1,2308,440,467
2,1978,1040,960,1040,131,1,7176,616,0
3,2004,1512,1512,1512,210,0,10141,845,0
1,1900,1844,709,1157,84,2,4800,240,687
1,1948,1458,912,912,192,1,17503,330,546
2,1879,2454,819,1312,0,1,13500,576,1142
3,2003,1455,1415,1455,156,1,3940,644,0
2,1921,2601,612,990,183,0,9842,621,1611
2,1966,2157,924,1216,105,2,14200,487,941
3,1998,2582,1389,1411,286,1,11002,758,1171
2,1992,1187,1168,1187,0,0,9556,420,0
2,1992,1287,624,624,150,0,10429,440,663
3,1880,3493,1470,1675,302,1,18386,870,1818
2,1977,1008,923,1008,201,1,9129,678,0
1,1950,1558,910,910,289,0,13710,282,648
1,1959,876,876,876,0,0,6410,320,0
1,1920,1802,793,901,0,1,7588,216,901
1,1942,1453,835,955,0,2,6360,240,498
2,1915,1338,832,846,0,0,7822,528,492
2,2004,1488,1488,1488,168,1,4835,506,0
1,1954,825,825,825,0,0,7200,350,0
3,2005,1616,1616,1616,208,0,8688,834,0
2,2006,1352,1352,1352,0,1,3606,466,0
2,2005,1072,547,1072,0,0,3675,525,0
2,2003,1080,530,530,0,0,4447,496,550
1,1924,872,872,872,0,1,17529,322,0
2,1980,788,728,788,133,1,4420,484,0
2,1999,1341,1341,1341,240,1,17227,482,0
0,1923,1828,859,942,174,0,9060,0,886
2,2000,1823,928,928,192,0,12192,626,895
2,1961,964,964,964,170,1,8243,784,0
1,1971,858,858,858,0,0,7340,684,0
2,2005,1364,1364,1364,192,1,7052,484,0
2,2004,1598,848,848,100,1,9171,433,750
2,2006,1797,939,939,144,0,9245,639,858
0,1902,1864,1020,978,0,0,5852,0,886
1,2004,1073,1073,1073,0,0,5500,246,0
2,1968,1770,900,884,0,0,8640,530,886
0,1947,912,0,672,0,0,6240,0,240
2,2005,1326,1326,1326,120,0,12216,388,0
2,1970,960,960,960,0,0,9873,576,0
2,1920,1376,768,752,0,0,8850,576,624
3,2009,1226,1226,1226,0,0,10402,740,0
2,1995,1734,1587,1734,52,0,8013,528,0
0,1965,1664,0,1664,0,0,9825,0,0
2,1980,1045,516,529,180,1,1782,462,516
1,1948,1224,816,816,414,0,8064,280,408
3,1994,2494,1290,1305,200,1,10236,803,1189
2,1969,988,938,988,0,2,21453,540,0
2,1990,1217,1188,1217,168,0,9947,497,0
3,2005,1838,1838,1838,161,1,11577,682,0
2,1922,1470,738,868,0,0,10560,624,602
1,1969,1479,864,864,287,0,10544,275,615
2,1955,864,864,864,196,0,8172,528,0
2,2004,1582,770,770,0,0,8320,520,812
2,1997,1692,878,892,0,1,9337,513,800
2,1936,1040,528,548,306,0,6240,624,492
1,1959,1440,1248,1440,150,0,9840,480,0
2,2008,1506,1498,1506,0,1,14587,592,0
1,1957,1306,992,1306,0,0,8712,756,0
2,1925,1281,1151,845,0,0,10284,580,436
1,1928,1576,1042,1042,0,1,6240,225,534
3,2004,2452,1117,1132,113,1,13418,691,1320
2,1967,1296,0,1296,0,0,10791,516,0
3,2005,2376,1158,1158,240,1,14215,853,1218
2,2002,1811,972,972,225,1,8470,565,839
1,1973,988,526,526,120,0,1974,297,462
3,1990,3222,1673,1699,367,2,12376,594,1523
2,1941,1604,984,984,0,0,10998,660,620
3,2005,1590,1570,1590,176,0,11645,754,0
1,1973,987,483,483,52,0,1680,264,504
1,1973,1092,546,546,120,0,1974,286,546
2,2002,1573,1573,1573,0,0,9808,544,0
1,1947,1054,1046,1054,0,0,9488,240,0
3,1998,1976,1044,1079,210,1,9660,885,897
2,1973,1242,1242,1242,0,1,9600,528,0
2,1979,1229,1094,1229,120,2,7040,672,0
0,1971,1824,912,912,128,0,9400,0,912
0,1956,882,882,882,0,0,5500,0,0
2,2003,1733,847,847,100,1,12394,433,886
2,1900,1699,978,1014,0,0,10615,420,685
0,1907,1884,707,942,0,0,6449,0,942
2,2001,1312,1267,1312,256,0,6718,471,0
2,1954,1375,1367,1375,0,1,11310,451,0
2,2009,1502,1502,1502,0,0,9541,644,0
3,2008,2234,2216,2234,0,1,17423,1166,0
1,1952,732,732,732,0,0,7200,240,0
2,2004,1200,600,600,0,0,2544,480,600
3,2008,1720,1720,1720,208,1,10816,846,0
2,1988,1509,1461,1509,224,1,10200,600,0
1,1976,1112,536,536,182,0,2592,336,576
2,1930,1801,697,1104,0,1,14210,365,697
3,1910,1521,741,780,0,0,9720,640,741
2,1954,1299,967,1299,81,1,11375,494,0
3,2002,1611,1569,1611,262,0,11664,1231,0
0,2005,1131,1131,1131,0,0,13072,0,0
2,2004,1680,840,840,0,0,3515,588,840
2,1981,1440,1440,1440,0,1,12546,467,0
2,1930,1920,960,960,248,2,7804,480,960
1,1954,1008,1008,1008,0,1,11425,275,0
2,2005,1585,784,831,100,0,7632,449,754
2,1977,1734,0,1302,0,0,10125,539,432
3,1976,1034,1012,1034,0,0,12328,888,0
2,1996,965,870,965,71,0,11105,580,0
2,1975,1456,855,855,173,1,2280,440,601
2,1957,1392,1392,1392,0,1,11341,528,0
0,1923,869,440,869,0,0,5900,0,0
3,2002,2004,870,878,0,1,12891,644,1126
2,1965,1625,1625,1625,0,0,9750,484,0
2,2000,1652,782,782,0,0,8998,532,870
2,1960,1179,1179,1179,0,0,8240,622,0
1,1918,838,816,838,0,0,10267,275,0
2,1994,1908,915,933,144,1,8750,493,975
1,1958,1276,1276,1276,0,0,9571,350,0
2,1999,1358,1339,1358,176,0,7321,625,0
2,1992,1737,836,844,192,0,8285,506,893
1,1962,1188,1188,1188,261,0,26142,312,0
2,1990,2503,1223,1271,0,1,19522,564,1232
2,1993,1820,864,920,144,0,11613,492,900
2,2002,1419,1487,1419,196,0,8773,543,0
2,1972,864,864,864,216,0,12735,576,0
2,2001,1492,1492,1492,0,1,11166,608,0
2,2007,1258,1246,1258,0,0,7697,462,0
2,2009,1218,1218,1218,0,0,9215,676,0
2,1960,1496,1296,1496,0,0,9600,450,0
2,2006,1495,738,738,100,1,8857,440,757
2,1969,2112,952,1092,280,2,11075,576,1020
3,2007,1580,1580,1580,0,0,11932,830,0
2,1965,912,912,912,0,0,8872,576,0
2,1979,1353,1259,1353,240,1,10400,478,0
1,1920,1510,755,755,0,0,4899,216,755
1,1925,1348,884,884,0,1,6000,216,464
3,1900,1774,1095,1095,0,0,9600,779,679
3,2007,1582,1582,1582,209,0,12704,905,0
2,1997,1337,1405,1337,0,1,10943,522,0
2,2007,1428,1428,1428,0,0,11639,480,0
1,1948,1082,1082,1082,0,1,11664,240,0
2,1956,1145,301,1145,0,0,7700,684,0
2,1968,1920,570,1222,0,1,10192,487,698
2,1958,1604,1604,1604,42,0,8267,576,0
1,1931,875,715,875,48,0,6120,180,0
2,1983,1080,1084,1080,120,0,9187,484,0
1,1954,1626,988,988,366,0,10512,332,638
2,1976,1178,1090,1178,0,0,11000,502,0
2,2003,2149,1434,1518,168,1,12822,670,631
1,1950,1164,1164,1164,0,0,10880,240,0
3,2003,2262,1482,1482,168,2,12244,749,780
2,1994,1481,702,702,0,1,8125,343,779
1,1971,1109,372,576,35,0,10500,288,533
2,1963,1054,936,1054,120,0,8800,480,0
2,1922,2555,588,1423,431,1,11526,672,748
1,1949,1268,832,1036,0,1,12144,288,0
1,1924,792,768,792,316,0,9022,240,0
2,2006,1125,1125,1125,80,0,8536,430,0
2,1964,1851,822,1020,239,1,9760,440,831
2,1900,2337,662,1422,0,0,13600,560,915
2,1990,1321,1312,1321,0,1,5118,484,0
2,1918,1674,1163,1163,72,1,21780,396,511
2,1973,1055,1044,1055,455,1,12712,542,0
2,2003,1560,1560,1560,100,0,9196,573,0
3,1958,1776,1584,1776,0,0,11475,888,0
1,1921,1343,731,820,192,1,7681,186,523
3,2006,1606,1598,1606,230,1,9658,871,0
3,1996,2032,1840,2032,0,0,23730,786,0
2,2004,848,848,848,140,1,4435,420,0
4,1922,1436,892,1254,0,1,10836,1488,182
2,1977,1694,1694,1694,501,1,14694,642,0
2,1992,3228,3200,3228,264,1,12692,546,0
2,1940,861,861,861,158,0,12342,539,0
2,2005,1504,1346,1504,156,1,3182,457,0
2,2007,1372,1372,1372,0,0,8640,529,0
2,1977,2020,0,2020,0,2,8400,630,0
2,1971,1258,1258,1258,55,0,11040,528,0
2,2001,1872,1299,1299,160,1,11885,531,573
1,1972,1218,672,672,0,0,1680,264,546
2,1983,902,864,902,164,0,8885,484,0
3,1990,2243,700,1122,127,1,13474,746,1121
2,2002,1492,1492,1492,277,1,8000,596,0
2,1978,1664,1664,1664,0,0,8385,616,0
1,1980,923,923,923,80,1,8012,264,0
3,1993,2646,1347,1372,340,1,9900,656,1274
2,1989,1337,1337,1337,0,1,5950,462,0
0,1890,1080,684,684,0,0,5914,0,396
2,1998,1779,866,866,198,0,10400,546,913
2,1973,2521,942,1291,728,1,3964,576,1230
1,1959,1053,1053,1053,0,0,10007,312,0
1,1950,1435,910,910,0,0,8674,308,525
2,1974,1037,1037,1037,136,0,10751,431,0
1,1964,1302,1302,1302,333,0,9350,309,0
2,1967,1691,1680,1691,0,0,9900,550,0
1,1929,1158,862,950,0,1,6000,208,208
0,1900,1294,0,694,220,0,10800,0,600
3,2006,1717,1709,1717,169,1,11146,908,0
3,2004,1914,1420,1426,168,1,13215,746,488
1,1930,935,742,779,0,0,9100,308,0
1,1926,2080,1276,1276,0,2,10918,282,804
2,2007,1728,1884,1728,0,1,11449,520,0
3,2005,2798,1398,1414,182,1,16023,670,1384
2,1977,1426,690,698,252,0,7950,440,728
2,1999,1501,1490,1501,144,0,10335,577,0
2,1992,2872,1683,2129,0,1,10678,541,743
1,1957,1340,0,1340,116,1,9060,252,0
3,2000,2234,1160,1205,0,1,9545,768,1029
2,1970,1002,1002,1002,0,0,8750,902,0
2,1977,1411,1386,1411,192,1,11900,544,0
2,1992,1923,750,1061,240,1,10186,564,862
1,1956,1050,1050,1050,0,0,9600,338,0
2,2004,1630,868,868,120,1,7984,436,762
3,2008,1612,796,796,0,0,12018,666,816
1,1962,1027,1027,1027,0,0,8000,299,0
2,2001,1212,1212,1212,356,0,9100,573,0
0,1910,1347,1117,820,85,0,7000,0,527
3,2007,1651,1643,1651,192,1,10235,870,0
3,1969,2544,1248,1248,0,0,9671,907,1296
1,1968,1056,1056,1056,0,1,8450,304,0
3,1998,1916,1049,1036,0,1,11050,741,880
2,1952,1960,960,960,0,0,7596,400,1000
1,1977,985,985,985,210,0,8385,328,0
1,1940,1134,756,756,0,0,8160,240,378
2,1998,1494,1482,1494,402,1,16196,514,0
2,1932,2345,952,1170,0,1,16560,360,1175
1,1968,1159,1051,1159,466,1,11553,336,0
2,2004,1119,835,1119,100,0,16219,437,0
1,1973,1218,672,672,0,0,2058,264,546
1,1938,1610,972,1052,0,1,18600,480,558
2,2006,1565,1511,1565,0,0,3784,476,0
3,2003,1575,1603,1575,216,1,10845,732,0
1,1954,1387,811,811,0,0,6000,256,576
2,2005,1247,1247,1247,0,1,3316,550,0
1,1925,641,641,641,184,0,7030,272,0
2,1992,1915,908,927,120,1,10041,506,988
1,1972,948,483,483,0,0,1680,264,465
3,2006,2121,2121,2121,124,1,14450,732,0
2,1999,2299,938,957,188,1,7500,482,1342
2,1998,1382,384,751,256,1,8923,396,631
1,1966,1040,1040,1040,0,0,11677,264,0
2,1914,1768,880,880,0,2,10800,320,888
1,1940,1034,735,735,0,0,10134,240,299
2,2002,1536,1536,1536,192,0,9135,532,0
2,1926,1281,756,903,25,0,6120,379,378
2,1966,1888,1517,1888,0,1,16492,578,0
2,1987,1479,1645,1479,224,1,14419,578,0
2,1920,861,861,861,0,0,7404,288,0
1,1966,894,894,894,0,0,7094,384,0
1,1910,1368,684,684,0,0,3600,216,684
2,1979,1224,1086,1224,120,2,7018,528,0
2,2008,1590,768,786,0,0,9000,676,804
2,1995,990,990,990,224,0,13568,576,0
3,2007,1464,1485,1464,168,0,15256,754,0
2,1980,1229,561,561,150,1,1300,462,668
0,1949,1588,448,1588,0,0,12205,0,0
3,2002,1689,1568,1689,150,2,13265,857,0
2,1971,1696,1696,1696,0,2,20693,625,0
2,1995,1671,781,781,0,1,13041,423,890
2,1978,1032,1032,1032,0,1,10395,564,0
2,2008,1566,1566,1566,144,0,9000,750,0
2,1970,1004,1004,1004,0,1,11241,480,0
2,1999,1779,951,951,208,1,13426,586,828
2,1950,1640,0,1640,0,1,21370,394,0
2,1995,1239,1230,1239,172,1,11064,477,0
2,2005,1200,600,520,0,0,3180,480,600
3,2008,2046,2046,2046,322,1,11844,834,0
2,2005,1476,738,738,100,0,8633,540,738
1,1954,948,864,948,0,0,10215,248,0
2,2003,1489,782,806,0,1,8965,400,683
2,1959,1588,0,1120,0,1,17120,680,468
1,1961,1774,552,904,290,1,15400,384,611
2,1957,1390,1705,1390,0,2,39384,550,0
1,1922,1048,993,1048,0,1,6380,280,0
2,1994,1516,707,707,0,1,8803,409,809
2,1984,1126,1060,1126,178,0,7400,506,0
1,1953,1647,1105,1647,225,1,9532,280,0
1,1967,1387,943,1387,0,1,7514,300,0
2,1979,1535,0,1535,0,0,7018,400,0
3,2006,1636,1623,1636,0,1,13501,865,0
2,1989,2519,1210,1238,320,2,26178,628,1281
2,2002,1660,831,831,144,0,8935,493,829
0,1936,800,264,800,0,1,6120,0,0
2,1997,1189,1189,1189,0,0,4500,392,0
2,1958,2144,1444,1444,0,2,159000,389,700
2,1925,1548,952,952,74,0,7264,672,596
1,1930,1108,637,1108,0,1,7449,280,0
1,1941,672,672,672,0,0,9340,234,0
2,1995,1470,680,680,192,1,8139,420,790
2,1980,2237,712,1375,305,1,9839,440,862
2,1960,1771,0,1771,0,1,21750,336,0
0,1900,797,245,797,0,0,9392,0,0
2,1964,1092,1092,1092,0,0,8250,504,0
3,2003,2400,1082,1105,114,1,13262,730,1295
2,2007,1372,1363,1372,192,0,8640,588,0
1,1958,1041,1041,1041,0,0,7350,294,0
2,1997,1308,635,646,142,0,10021,497,662
3,2005,1792,1792,1792,204,1,13758,925,0
1,1962,936,896,936,24,1,6760,288,0
3,2006,1537,1518,1537,0,0,11563,788,0
2,1998,1638,943,943,100,2,9042,472,695
1,1941,924,672,672,0,0,12180,280,252
2,1976,958,958,958,0,0,4928,440,0
2,1997,2098,1040,1044,331,1,9375,621,1054
2,1974,1434,1434,1434,80,1,10200,528,0
1,1941,1376,768,968,0,1,9492,240,408
2,2004,848,848,848,149,1,4426,420,0
1,1941,1131,676,676,26,0,5720,200,455
1,1975,918,852,918,192,0,8750,360,0
2,1974,1116,1116,1116,0,1,10140,528,0
3,2006,1959,1088,1088,208,1,9000,1025,871
2,2007,1356,628,628,100,1,10616,484,728
2,1976,1262,1262,1262,298,1,9600,460,0
3,2006,1795,1795,1795,0,1,9986,895,0
2,1974,2067,752,1285,297,2,12732,784,782
3,2006,2140,2140,2140,136,0,10481,894,0
1,1970,1092,546,546,238,0,2217,286,546
3,2008,1808,1774,1808,200,1,13514,850,0
1,1963,1117,1117,1117,0,0,7590,264,0
0,1974,1792,896,896,32,0,9000,0,896
2,1970,1365,765,765,0,0,2368,440,600
3,2006,2748,1850,1850,212,1,13418,850,898
1,1950,1200,1200,1200,126,0,9600,246,0
2,1997,1629,928,928,212,1,13830,482,701
1,1956,1144,1144,1144,44,0,9571,596,0
3,2007,1978,1978,1978,308,1,12633,920,0
3,2007,2078,1034,1050,0,1,10800,836,1028
3,2005,1876,1308,1308,0,0,11003,848,568
1,1967,941,912,941,64,1,8789,288,0
3,1993,2197,1080,1108,385,1,10010,783,1089
2,1999,1739,970,983,115,0,2645,480,756
1,1900,1440,540,889,0,0,5000,352,551
1,1924,1032,1032,1032,0,0,7741,280,0
2,1980,2353,845,1153,288,1,13005,484,1200
2,1960,2069,585,2069,0,1,27650,505,0
1,1945,793,793,793,0,0,8480,240,0
0,1935,754,520,520,53,0,6780,0,0
2,1964,1425,1425,1425,0,1,10175,576,0
2,1976,1060,1040,1060,100,1,4224,572,0
2,2003,1080,530,530,0,0,2403,496,550
2,1978,1664,1529,1664,0,1,12299,663,0
1,1937,1768,731,981,0,2,7200,240,787
2,1914,1264,676,676,424,0,15564,400,588
2,1964,1152,1152,1152,227,1,14112,484,0
0,1955,1152,0,1152,0,0,6012,0,0
2,2000,1936,1406,1454,188,1,11194,504,482
1,1923,1292,949,949,0,0,5142,205,343
2,2007,1266,1266,1266,100,1,3710,388,0
2,2007,1456,728,728,100,0,7713,400,728
1,1926,1422,1290,1422,0,0,7223,352,0
3,2006,1863,879,879,100,1,14054,660,984
2,1989,2559,868,1313,0,1,12128,506,1246
1,1930,1248,912,912,0,0,9439,160,336
3,2006,1962,1391,1391,0,0,8760,868,571
2,1992,1187,1168,1187,483,0,7980,420,0
2,1962,1560,1776,1560,453,1,11679,528,0
2,1998,2393,970,1469,0,1,3951,846,924
2,1964,1452,1420,1452,92,1,11235,572,0
2,2003,1668,1657,1668,0,1,10635,502,0
1,1961,896,882,896,140,0,11622,730,0
2,2004,1659,831,831,144,0,11920,484,828
1,1984,1049,1049,1049,0,0,4235,266,0
0,1946,666,666,666,0,0,5000,0,0
0,1991,974,974,974,0,0,10712,0,0
1,1959,988,988,988,156,0,9240,297,0
2,1953,1094,1094,1094,0,2,10452,495,0
2,1969,1082,973,1082,160,0,8723,480,0
2,1997,1764,928,928,276,0,15426,470,836
2,1993,1642,903,910,290,1,7655,392,732
2,1967,1632,1632,1632,0,0,25000,576,0
1,1960,1422,978,1422,0,1,12342,286,0
2,2004,1245,1235,1245,0,0,3435,495,0
2,1979,914,914,914,0,0,6950,444,0
2,1990,2810,1453,1453,500,1,9572,750,1357
1,1956,1200,1200,1200,0,2,10400,294,0
1,1957,816,816,816,0,0,7100,308,0
2,2002,1762,826,878,320,0,9930,591,884
2,1996,1992,860,1212,225,2,15295,608,780
2,2003,2094,912,912,182,1,9375,615,1182
1,1940,1595,940,1192,0,2,8400,240,403
0,1946,1195,1195,1195,118,0,8741,0,0
2,2005,1611,784,784,144,0,8400,572,827
2,1924,1430,596,834,218,0,10320,370,596
1,1976,1092,546,546,0,0,1890,286,546
3,1999,2365,1252,1268,0,1,9430,856,1097
2,2006,1352,1352,1352,0,1,4230,466,0
2,2004,1535,1517,1535,0,0,10171,532,0
2,2004,1414,707,707,100,1,9056,403,707
2,1976,1964,803,1098,0,1,10480,483,866
1,1930,1755,930,1230,0,1,7810,231,525
1,1939,1322,672,899,0,0,6240,280,423
2,1961,864,864,864,0,0,8499,732,0
2,1951,1220,836,1220,0,0,8877,396,0
2,1974,1309,1040,1309,265,1,10140,484,0
1,1925,765,765,765,135,0,5000,200,0
2,1993,1470,680,680,232,1,9765,420,790
2,1994,1694,392,924,256,1,10147,398,770
2,1988,1873,929,946,108,1,8883,619,927
1,1953,1728,1216,1216,200,1,12099,371,0
1,1928,1477,861,877,0,1,6292,216,600
1,1994,990,990,990,0,0,8775,299,0
2,2003,1094,1094,1094,0,0,12450,576,0
2,1927,1028,1008,1028,0,1,8960,360,0
2,1986,2726,279,2726,216,1,18044,691,0
2,2004,848,848,848,140,1,4438,420,0
2,2008,1726,1726,1726,0,1,3830,561,0
3,2002,1629,1616,1629,0,1,14536,808,0
2,2004,1836,1860,1836,120,1,9100,484,0
2,2004,1812,835,871,146,0,10628,478,941
1,1939,1577,972,972,0,1,6435,312,605
2,1997,1417,1417,1417,60,1,8750,511,0
2,1915,1595,663,774,49,1,7200,528,821
2,2005,1141,1141,1141,0,0,13072,484,0
3,2006,1816,1790,1816,186,1,12469,730,0
3,2007,1704,1704,1704,0,1,11478,772,0
1,1956,1229,1134,1229,0,0,17140,284,0
2,1979,1782,1782,1782,467,1,14450,551,0
2,1980,1032,516,516,213,1,1879,462,516
1,1896,952,756,952,0,0,8712,330,0
2,1999,1344,1344,1344,328,1,11875,686,0
1,1956,1014,0,1014,0,0,7785,267,0
2,1910,1363,622,741,0,0,7740,528,622
2,1966,1839,756,1051,0,1,7700,442,788
1,1954,1128,936,1128,0,0,9000,286,0
3,2007,1615,1615,1615,168,1,9345,864,0
1,1972,1030,494,494,0,0,1890,264,536
1,1920,1657,1147,1147,0,1,5520,162,510
2,1959,1712,1626,1712,272,0,8393,588,0
2,2003,848,848,848,140,0,4435,420,0
2,1979,1535,0,1535,0,0,7018,410,0
2,1998,1772,928,928,150,1,8750,492,844
1,1941,2340,1152,1188,0,2,9042,252,1152
2,1976,1548,804,804,48,1,2308,440,744
0,1931,1666,894,894,0,1,9839,0,772
4,1997,1344,1344,1344,0,0,7060,784,0
3,2008,2713,1452,1476,126,1,14948,858,1237
2,2003,848,848,848,140,0,4435,420,0
1,1928,1143,1008,1143,265,1,7111,288,0
1,1939,845,0,640,48,0,11067,256,0
0,1958,960,960,960,0,0,6410,0,0
1,1936,2057,1017,1020,0,1,11500,180,1037
1,1957,1638,967,967,0,0,9060,384,671
2,1948,1687,747,1687,0,2,57200,572,0
2,2000,1524,756,768,0,0,2998,440,756
1,1880,1750,636,1089,0,0,9000,240,661
2,1974,894,864,894,0,0,11800,440,0
2,1900,1798,1075,1156,0,0,9639,342,642
1,1923,1200,1200,1200,0,0,11340,312,0
2,2006,1652,1652,1652,404,2,13173,840,0
2,1954,1640,1296,1640,108,1,14778,924,0
2,2004,1709,970,970,0,0,2522,380,739
1,1924,1221,784,949,0,0,9738,392,272
2,1941,803,720,803,0,0,5000,360,0
2,2007,1396,608,608,100,1,11069,440,788
0,1916,936,216,576,0,0,8520,0,360
1,1968,1052,1052,1052,356,0,8400,288,0
2,2007,1768,866,866,144,0,10769,578,902
2,2005,1686,891,891,144,0,7800,462,795
2,1998,1604,926,926,100,0,9535,472,678
2,1910,2104,1226,1226,0,0,6300,432,878
2,1919,1824,764,1060,0,1,13515,520,764
2,1993,2232,1173,1215,173,1,11692,623,1017
2,1958,1920,1052,1252,0,1,13650,451,668
2,2003,2014,912,1072,124,0,9157,486,942
2,1988,1228,1228,1228,168,1,4671,472,0
2,1949,1556,782,1019,0,1,17360,470,537
2,1947,1664,1004,1004,0,2,5000,420,660
1,1971,987,483,483,0,0,1680,264,504
2,1968,1556,727,829,0,0,11700,441,727
2,2006,1625,1573,1625,123,1,4750,538,0
2,2003,1700,1682,1700,192,0,9135,544,0
1,1958,1955,1151,1151,0,0,9000,356,804
1,1945,808,0,808,0,0,6120,164,0
2,1929,854,832,854,48,0,6120,576,0
1,1958,1138,588,1138,224,0,10482,264,0
2,1999,1675,841,892,0,1,24682,502,783
2,1990,1341,1300,1341,192,1,10176,506,0
1,1968,1196,1196,1196,257,0,10044,336,0
3,2008,3140,1926,1966,144,2,13518,820,1174
1,1910,1273,616,1055,212,0,11388,275,218
3,1928,2009,672,1337,0,2,19950,795,672
3,1993,2097,1080,1080,196,1,11228,678,1017
2,1915,1768,1048,1048,0,0,8094,576,720
1,1924,1669,1093,1093,0,0,8707,288,576
2,1970,2207,1947,2207,301,1,19900,576,0
2,2003,1663,835,835,168,0,12774,478,828
2,1993,1190,1181,1190,0,1,7250,430,0
2,2005,1504,1346,1504,156,1,3182,437,0
2,1996,2049,1065,1065,120,1,21533,467,984
1,1942,1494,771,753,0,2,7500,213,741
2,1958,1261,1261,1261,0,1,9120,433,0
2,1975,1552,713,811,209,1,11475,434,741
2,1993,1501,697,697,190,1,7685,420,804
0,1919,1517,793,997,0,0,8500,0,520
1,1926,1111,572,572,0,1,5700,288,539
1,1969,971,971,971,0,1,9920,300,0
1,1900,1836,686,1150,0,0,56600,288,686
3,2005,1698,1698,1698,192,1,11520,730,0
2,1969,1026,1026,1026,171,0,7930,440,0
2,2006,1612,1612,1612,0,1,8035,556,0
1,1966,1128,1080,1128,238,1,11380,315,0
3,2005,2795,1390,1390,272,1,15922,660,1405
2,1995,1680,1680,1680,152,0,17871,628,0
3,2007,2520,1508,1508,192,1,23303,640,1012
1,1951,1600,0,1600,0,0,31250,270,0
2,1990,1332,1332,1332,0,0,7175,542,0
1,1950,1904,1208,1136,0,0,7200,240,768
3,2009,2020,2006,2020,156,1,12220,900,0
3,2006,2338,2660,2338,0,2,51974,1110,0
2,2006,1458,608,608,100,0,13204,454,850
1,1965,960,648,960,88,0,10246,364,0
2,2004,1694,1686,1694,255,1,10084,636,0
3,2005,2482,1094,1133,144,1,12665,642,1349
2,1959,1580,1244,1580,0,2,10032,440,0
1,1966,1092,1092,1092,259,0,9825,264,0
2,1997,2034,1057,1057,576,0,9375,645,977
0,1940,996,996,996,144,1,13907,0,0
2,1977,1432,716,716,0,1,8286,531,716
0,2006,1140,1140,1140,36,0,17217,0,0
2,1994,2110,948,1222,0,2,8880,463,888
3,2007,2100,918,958,172,2,9709,786,1142
2,1969,1308,720,720,0,0,9743,484,588
0,1987,1200,1200,1200,120,0,10800,0,0
2,2008,1402,1402,1402,205,0,8640,625,0
1,1967,1107,949,1107,88,0,8050,308,0
2,1977,1969,808,1161,0,1,11952,534,808
2,1965,1820,864,902,60,2,13700,492,918
0,1920,605,528,605,0,0,9098,0,0
2,2000,1514,794,819,0,1,8433,394,695
2,1979,2233,0,1100,0,0,9555,579,1133
2,2000,1638,1614,1638,230,1,4765,495,0
0,1970,1092,546,546,0,0,1526,0,546
3,1999,2270,1152,1164,132,1,11764,671,1106
2,1993,1337,1337,1337,96,1,5395,462,0
1,1910,1635,485,1001,394,0,5310,255,634
1,1971,950,950,950,0,0,9758,280,0
2,1971,864,864,864,0,0,7560,576,0
1,1961,1150,1150,1150,0,0,7000,288,0
3,1935,3447,728,1968,314,2,14100,1014,1479
1,1926,1616,1149,1149,0,0,5400,216,467
1,1948,1668,1212,1226,0,0,9600,240,442
1,1921,1424,1228,1424,0,1,7290,312,0
2,1999,1557,1557,1557,124,1,4109,484,0
2,1957,1790,998,1790,0,2,14250,540,0
2,2006,2021,868,887,0,1,23257,422,1134
2,1999,1588,1588,1588,158,0,10264,472,0
2,1994,1721,928,936,300,0,8462,471,785
2,2003,1121,1121,1121,132,0,8546,440,0
3,1997,2551,1779,1779,76,2,12191,925,772
2,1978,1373,1319,1373,0,2,7424,591,0
2,2005,1714,1714,1714,156,1,8147,517,0
2,1978,1295,1057,1295,133,2,3840,571,0
2,1948,1323,780,948,0,0,9184,400,375
1,1960,1134,1010,1134,0,0,7000,254,0
2,1972,1193,1153,1193,140,0,13110,501,0
1,1901,1214,969,969,0,0,5680,216,245
1,1956,1196,1196,1196,0,1,9000,297,0
2,2004,1646,1594,1646,128,1,3811,482,0
3,2006,2698,1850,1850,250,1,16052,736,848
2,1957,1347,1347,1347,0,0,5805,551,0
2,1964,1775,533,1131,0,0,10600,480,644
2,1910,1306,240,810,0,0,15660,472,496
2,2003,1320,660,660,0,0,7750,400,660
2,1972,894,894,894,215,0,7200,600,0
1,1948,789,789,789,0,0,6000,250,0
2,2001,2439,1531,1531,184,1,12728,560,908
2,1999,1452,691,713,0,0,3735,506,739
1,1966,988,988,988,0,0,7150,360,0
2,1969,1632,784,784,0,1,10457,898,848
2,2006,1491,738,738,100,1,8333,484,753
3,1995,3238,2033,2053,283,1,14720,666,1185
2,1900,2414,954,1766,142,1,10800,520,648
2,1965,1728,1728,1728,0,0,13101,576,0
2,1977,1602,1602,1602,240,1,16635,529,0
2,2003,1146,868,1146,160,1,9590,438,0
2,2002,1509,783,807,100,1,7861,393,702
2,1900,2014,716,1007,0,0,9856,624,1007
2,1962,2448,1438,1900,520,2,18275,441,548
2,1959,3820,0,3820,0,2,47007,624,0
1,1961,864,864,864,158,0,9079,440,0
1,1959,1246,1246,1246,218,0,7500,305,0
2,1999,1549,744,757,0,0,2280,440,792
1,1948,1271,720,720,0,1,21286,312,551
1,1920,840,798,840,112,0,5747,250,0
2,1988,1179,1166,1179,0,0,4740,480,0
2,2006,1208,1187,1208,105,0,6762,632,0
2,1910,1230,440,682,74,0,10440,440,548
2,2002,1795,1777,1795,171,1,9742,534,0
3,2008,5095,5095,5095,546,2,39290,1154,0
2,1900,1951,938,1084,0,0,7745,576,867
3,1996,2340,1236,1236,192,1,14311,787,1104
3,2008,1578,1573,1578,0,1,9262,840,0
2,2000,1382,673,673,153,0,2651,490,709
2,1980,1472,1372,1472,233,2,14115,588,0
2,1999,1644,941,961,460,1,9649,460,683
2,2008,1884,1884,1884,231,1,7390,649,0
2,2005,1223,600,520,0,0,2544,480,623
1,1980,1700,430,880,188,0,1700,450,680
0,1977,1440,1440,1440,321,0,7711,0,0
2,2002,1459,1459,1459,192,1,8749,527,0
1,1953,773,773,773,0,0,7677,240,0
1,1945,1668,672,1195,210,0,7425,252,473
2,1995,1200,1200,1200,0,0,11249,521,0
1,1950,1078,1078,1078,366,0,9717,240,0
1,1963,1045,1045,1045,0,1,7936,264,0
2,1990,1339,1309,1339,0,1,8049,484,0
3,2006,1795,900,909,168,1,10603,782,886
2,1990,1442,910,1442,0,1,10357,719,0
2,1950,1048,0,1048,0,0,7200,420,0
2,2005,1456,728,728,100,0,8029,400,728
2,1959,1466,1466,1466,0,2,17755,528,0
2,1963,1328,1328,1328,0,2,9790,528,0
1,1956,882,882,882,0,0,13008,502,0
1,1959,1328,1350,1328,0,2,16905,308,0
2,2007,1528,1528,1528,0,1,9965,480,0
2,2004,1422,1422,1422,192,0,8500,626,0
2,1953,950,984,950,0,0,12774,400,0
2,1988,1714,980,980,228,1,10421,496,734
2,2003,1768,884,884,0,0,8158,543,884
1,1960,1507,1075,1507,0,0,7910,404,0
2,1941,1382,720,854,237,0,12358,660,0
3,2006,1646,1638,1646,192,1,10656,870,0
3,2004,1576,1393,1576,143,1,3940,668,0
2,1963,970,970,970,0,0,8480,624,0
1,1950,1952,976,976,285,2,9780,299,976
2,1993,2495,1280,1280,224,1,10791,660,1215
1,1945,640,0,640,0,0,8777,240,0
2,1977,1844,1844,1844,0,1,11751,546,0
2,2006,1364,1220,1364,100,1,3087,437,0
2,1994,990,990,990,0,0,8072,480,0
2,1976,1398,684,684,0,1,7200,440,714
2,1951,1112,631,1112,0,0,13070,480,0
0,1964,912,912,912,0,0,8020,0,0
2,1964,1516,1516,1516,0,0,10004,472,0
2,1915,1308,880,880,0,0,10320,400,428
1,1925,1608,976,1160,147,1,6171,216,448
1,1961,914,914,914,140,0,17199,270,0
2,1940,1567,840,840,0,2,13680,440,727
2,1990,1717,1156,1187,168,1,13758,400,530
2,1951,1226,0,1226,174,1,13108,400,0
1,1940,1308,728,976,0,2,9600,256,332
1,1959,1144,1144,1144,86,1,8163,796,0
2,2005,1530,1530,1530,168,1,16158,430,0
2,2007,1792,896,896,184,0,8640,590,896
2,1964,1488,1008,1488,154,1,10368,430,0
2,1996,1040,1040,1040,168,0,12464,576,0
2,1916,1196,1196,1196,0,0,4800,440,0
1,1968,874,864,874,0,0,10172,288,0
0,1923,2592,1296,1296,0,0,10890,0,1296
2,1961,1187,864,1187,128,1,14357,440,0
2,2004,848,848,848,149,1,4438,420,0
2,1999,1501,744,757,0,0,2280,440,744
2,1950,2177,1032,1102,0,0,15600,484,1075
2,1951,1575,216,1575,0,1,10170,400,0
2,1924,1566,816,816,24,0,6000,450,750
2,1998,1478,1418,1478,168,0,7380,495,0
1,1954,1268,1268,1268,0,1,7800,244,0
2,2007,1218,1218,1218,0,0,9605,576,0
1,1959,1040,1040,1040,140,0,7560,286,0
2,2005,1577,1577,1577,203,1,7841,564,0
1,1971,1092,525,525,0,0,1680,320,567
2,1979,2228,0,1114,73,0,7018,720,1114
2,1929,1316,926,926,0,0,5500,484,0
2,2004,1445,1445,1445,0,0,9750,470,0
2,2005,1768,866,866,0,0,9803,603,902
2,1996,1288,1260,1288,120,2,14963,500,0
2,1971,1220,1625,1220,0,1,13001,944,0
2,1955,960,960,960,0,0,6000,576,0
3,2004,1713,1713,1713,0,1,9591,856,0
1,1958,1442,1442,1442,0,0,9750,301,0
1,1953,930,911,930,134,0,9520,286,0
2,2000,1674,814,814,0,0,7500,663,860
2,2003,1394,384,754,100,1,11950,400,640
3,1995,2531,1318,1328,222,1,12257,752,1203
2,2001,2035,884,884,144,1,9505,434,1151
1,1975,1096,1008,1096,0,1,6305,352,0
3,1993,2799,1286,1565,432,1,12585,704,1234
1,1885,1047,641,1047,0,0,10800,273,0
1,1998,767,723,767,120,0,4058,367,0
2,2005,1302,1302,1302,110,1,3901,631,0
2,1989,1495,1495,1495,252,1,12890,438,0
1,1976,1125,1041,1125,296,1,7200,352,0
1,1930,813,813,813,0,0,5684,270,0
1,1963,1651,725,1035,460,2,10090,276,616
2,1985,1502,1488,1502,0,0,6820,528,0
3,2001,2633,2633,2633,314,2,11400,804,0
1,1976,894,894,894,365,0,10650,308,0
1,1920,1012,1012,1012,0,1,8263,308,0
2,1988,1680,880,1680,292,1,21695,540,0
1,1916,2526,714,1664,88,1,8520,216,862
3,2004,2224,1462,1462,184,1,8834,738,762
1,1940,2403,1032,1207,56,2,24090,349,1196
2,1938,1969,1272,1272,0,1,6876,400,0
1,1967,1141,1141,1141,0,0,9600,568,0
2,2006,1278,1278,1278,0,0,8640,584,0
2,1986,1501,1277,1501,240,1,4084,512,0
2,1968,1721,1461,1721,0,1,10335,440,0
2,2005,1904,1058,1058,179,1,10927,736,846
2,1990,1061,1054,1061,114,0,10778,462,0
2,1940,908,822,908,284,0,12172,512,0
2,1984,1097,1040,1097,0,0,9672,480,0
1,1910,810,0,810,119,0,21780,280,0
2,1974,894,864,894,241,1,13350,440,0
2,1966,1280,793,1280,140,1,10050,432,0
2,1999,1404,672,684,20,0,2160,462,720
1,1967,992,992,992,204,0,10265,294,0
2,1935,2108,1127,1236,0,2,13728,540,872
0,1972,630,630,630,96,0,1491,0,0
1,1940,1510,755,755,120,1,9084,296,755
1,1945,2320,1028,1436,224,1,7259,180,884
2,1992,1280,1280,1280,0,0,5070,506,0
2,1998,2362,1220,1220,147,2,8413,1105,1142
2,1976,1142,1142,1142,536,1,4224,528,0
2,1976,1728,1728,1728,40,0,12640,574,0
1,1966,892,864,892,0,0,7800,416,0
2,1970,1682,1304,1682,98,1,10400,530,0
2,1995,2020,1128,1142,0,1,9828,466,878
2,1948,1320,768,819,108,0,8064,576,501
1,1942,1644,728,888,168,2,9480,312,756
3,2007,1466,1466,1466,100,0,8925,610,0
2,2006,1484,1476,1484,120,1,9037,472,0
2,1999,1873,988,988,202,1,10820,597,885
3,2005,2541,1149,1164,120,1,12328,729,1377
1,1959,1183,528,1183,0,0,8000,288,0
1,1980,1266,630,630,340,2,8012,283,636
2,2004,1374,384,744,0,0,9734,400,630
1,1948,869,0,869,0,0,10122,390,0
3,2005,2212,1700,1700,237,1,13751,773,512
3,2008,1702,1702,1702,0,1,8769,1052,0
1,1920,865,660,740,0,1,10042,216,125
3,2006,2596,1249,1249,240,0,16259,840,1347
2,1971,981,981,981,0,0,10530,576,0
2,1959,1801,1501,1801,0,2,15602,484,0
1,1925,1328,686,810,0,0,9906,210,518
1,1930,1001,837,1001,154,0,6060,216,0
1,1938,1360,803,803,0,0,7200,297,557
1,1957,1526,1216,1526,116,1,8562,364,0
2,2005,1422,704,704,36,1,11646,440,718
1,1965,935,935,935,180,0,13526,288,0
2,2005,1266,1257,1266,38,1,7500,453,0
1,1922,2068,1108,1160,0,1,7793,315,908
1,1958,1329,1329,1329,393,0,14267,312,0
2,1983,2132,1496,1496,349,1,12327,612,636
3,2005,1595,1595,1595,144,1,8987,880,0
2,1994,2127,1223,1223,171,2,10944,525,904
2,2000,1673,1673,1673,306,1,11354,583,0
2,1995,1253,1237,1253,220,1,7875,402,0
0,1970,1092,546,546,187,0,1477,0,546
2,1977,2263,795,1468,0,1,16659,539,795
2,2005,1200,600,520,0,0,3180,480,600
1,1931,1502,776,851,0,1,7200,270,651
2,2003,848,848,848,140,0,4435,420,0
2,2006,2234,2220,2234,390,1,14082,724,0
1,1969,1216,1216,1216,0,0,9000,336,0
2,1979,1725,539,1040,0,1,11584,550,685
2,2002,1989,1065,1091,199,1,11367,586,898
3,2006,1838,1838,1838,270,1,14601,765,0
2,1959,1252,1252,1252,0,0,10721,528,0
2,2007,1246,1146,1246,100,1,3710,428,0
3,1995,1511,1401,1511,168,1,11454,811,0
1,1956,960,672,960,64,0,8926,288,0
2,2002,1812,952,952,144,1,7500,469,860
1,1926,789,768,789,0,0,10594,200,0
2,1950,1040,0,1040,0,0,7200,420,0
3,1994,2526,1165,1203,309,1,10120,844,1323
3,2008,1743,1739,1743,168,1,10367,927,0
2,1962,1211,864,1211,161,1,9240,576,0
2,1918,1416,816,1416,0,0,25339,576,0
1,1939,1412,780,825,45,1,6000,280,587
3,2009,1940,1930,1940,168,1,10159,606,0
2,2005,1456,728,728,0,1,8461,390,728
1,1971,987,483,483,275,0,1680,264,504
2,1999,1586,960,962,169,0,2645,480,624
1,1950,1152,1092,1152,0,1,14000,300,0
1,1972,864,864,864,0,0,7180,352,0
1,1972,1092,525,525,352,0,1680,264,567
2,1991,1274,624,624,22,0,10475,576,650
1,1977,926,902,926,319,1,9750,351,0
1,1930,1426,966,1014,174,1,6240,230,412
2,1977,1654,0,1286,0,0,8927,528,368
2,1981,1740,1740,1740,228,0,15417,540,0
2,2006,1534,1524,1534,168,1,10612,484,0
2,1955,1779,1763,1779,0,1,17920,454,0
2,1977,1040,1040,1040,0,0,8800,484,0
1,1958,1339,1029,1339,0,0,7560,294,0
2,1956,1689,1436,1689,0,1,9855,480,0
1,1922,1154,796,796,0,0,5436,240,358
2,2002,1908,967,993,135,0,14191,431,915
3,2006,1973,1935,1973,315,1,14226,895,0
2,1998,2031,1153,1153,192,1,11404,541,878
1,1965,1020,1024,1020,171,0,9316,288,0
3,2004,1618,1618,1618,0,1,16163,880,0
2,2007,1504,752,752,100,0,8229,440,752
2,1976,1062,1029,1062,120,2,11333,539,0
1,1961,912,912,912,168,0,6768,288,0
2,2004,1374,384,744,100,1,9434,400,630
2,1928,1378,689,689,0,1,9600,360,689
2,1972,1381,1161,1381,0,1,9360,676,0
4,1997,1368,1288,1368,0,0,7020,784,0
2,2007,1208,1208,1208,105,0,6762,628,0
2,1997,1950,975,975,0,1,7399,576,975
2,1975,879,864,879,0,0,9675,440,0
2,1948,1527,699,801,0,1,11419,410,726
2,1947,1312,784,900,0,0,7500,649,412
2,1976,1620,1281,1620,120,1,9991,490,0
1,1963,960,960,960,168,0,9239,300,0
2,2004,1484,1473,1484,0,0,8400,606,0
1,1925,1159,747,747,84,0,7506,288,412
2,1977,1334,1350,1334,0,1,9650,630,0
3,2008,1346,1336,1346,100,1,11896,660,0
2,1978,1386,672,672,335,1,11616,440,714
2,2004,1374,384,744,100,1,13300,400,630
3,2009,1766,1766,1766,195,1,9187,478,0
3,2008,1468,1468,1468,210,1,9612,898,0
3,2005,1801,893,901,0,1,10463,800,900
1,1967,900,864,900,175,1,7838,288,0
2,1925,1694,1181,1390,342,1,8400,576,304
2,1968,1743,702,1041,224,1,11700,539,702
2,1977,980,980,980,192,0,7064,484,0
3,2007,1861,1341,1341,144,1,9801,851,520
1,1957,907,907,907,0,0,8593,352,0
2,1994,1097,1097,1097,392,0,10859,672,0
2,2003,2314,1150,1164,0,1,11060,502,1150
1,1938,1551,1058,1058,0,0,10890,240,493
2,1916,1232,816,1232,0,1,8574,440,0
2,2005,1541,1541,1541,0,1,12182,532,0
2,1993,1571,799,799,0,1,7837,380,772
2,1928,1981,1122,1328,431,2,7804,576,653
0,1910,1184,658,658,0,0,8410,0,526
2,2004,1221,1221,1221,0,0,7500,400,0
1,1914,864,864,864,0,0,8212,200,0
2,1998,2097,1108,1108,253,1,9750,583,989
1,1977,1026,1026,1026,316,0,15240,308,0
3,2008,1630,1622,1630,172,1,10226,860,0
2,1998,1886,930,956,89,1,11214,431,930
2,1982,858,858,858,120,0,7252,576,0
2,1978,1671,1427,1671,252,1,10928,484,0
1,1890,725,630,725,0,0,10800,320,0
2,2005,1716,858,858,0,0,8125,615,858
1,1959,1194,1194,1194,0,0,8760,312,0
1,1967,1073,1073,1073,0,0,9981,270,0
1,1935,1738,1024,1144,0,1,7010,240,594
1,1939,1274,728,728,0,0,6125,224,546
2,2008,1436,1436,1436,0,0,7993,529,0
1,1953,1154,864,1154,63,0,11556,336,0
2,1920,1762,596,998,36,0,7200,576,764
1,1955,1057,1057,1057,0,0,10519,288,0
3,2006,1402,1258,1402,120,1,3922,648,0
2,1988,1872,1845,1872,197,1,10400,604,0
2,2001,1961,804,804,125,1,12209,560,1157
2,1961,1433,1251,1433,144,1,9600,441,0
2,2000,2256,952,980,224,1,8795,554,1276
3,2000,1865,992,992,0,1,10316,839,873
1,1940,612,0,612,0,0,5925,308,0
0,1910,816,624,816,0,1,3300,0,0
2,2007,1361,1351,1361,0,0,9627,610,0
1,1966,1059,1059,1059,0,0,9000,286,0
2,1976,1548,804,804,108,1,2308,440,744
3,2000,2285,969,997,0,1,11000,648,1288
3,2007,1620,1620,1620,228,1,12898,912,0
3,2005,2331,1414,1414,192,1,12151,1003,917
2,1927,1718,851,867,291,1,7230,264,851
3,1993,2349,1231,1251,32,1,13143,762,1098
2,1923,1635,1065,915,0,1,8737,440,720
2,2001,1419,1419,1419,155,1,4385,588,0
1,1962,999,999,999,0,0,7758,264,0
0,1987,1200,1200,1200,120,0,10800,0,0
1,1927,968,656,968,0,0,10800,216,0
2,2001,1434,1454,1434,290,1,8529,527,0
1,1954,948,948,948,0,1,8190,280,0
1,1937,1375,780,780,0,1,9000,544,595
2,1955,1588,768,1024,0,0,7200,480,564
2,1986,2093,791,1236,364,1,20544,542,857
1,1957,1600,1484,1600,288,2,16321,319,0
3,2008,2020,2020,2020,192,1,12350,896,0
1,1962,1696,1140,1696,0,1,13673,349,0
2,1926,1285,861,861,96,0,7000,506,424
2,2003,848,848,848,140,0,4435,420,0
2,1940,1656,801,1095,187,0,7628,440,561
2,1986,1651,1606,1651,192,1,12416,616,0
1,1977,1388,675,686,406,0,8340,317,702
0,1947,1137,0,929,0,0,8050,0,208
2,1958,951,951,951,0,0,8010,480,0
2,1995,1609,754,754,0,0,8453,525,855
1,1966,892,864,892,0,0,9477,264,0
1,1950,1113,1113,1113,0,1,9600,264,0
2,2004,1436,1436,1436,139,0,8450,484,0
3,2001,1787,1753,1787,198,1,14781,748,0
1,1954,901,901,901,0,0,6000,281,0
2,2003,2048,1054,1072,0,2,8010,552,976
2,1981,2497,2461,2497,266,2,17778,676,0
2,2005,1838,732,734,100,1,21930,372,1104
2,1964,1611,780,798,328,0,9760,442,813
2,1962,1734,912,1085,0,1,9786,440,649
2,2005,1484,783,783,0,1,10237,393,701
2,1977,2022,1160,1156,288,1,10005,505,866
2,2003,1653,812,812,0,0,8127,628,841
3,2008,2018,2002,2018,144,1,13214,746,0
3,2002,1668,1626,1668,257,1,11248,702,0
2,1987,1767,1064,1064,441,1,5306,504,703
3,2008,2822,1734,1734,52,1,13891,1020,1088
3,2009,1680,1555,1680,185,1,10933,1138,0
3,2004,1836,1836,1836,125,1,11362,862,0
3,2005,1614,1614,1614,144,0,11210,865,0
2,2005,1468,1468,1468,0,1,10440,528,0
2,1966,1232,1232,1232,0,0,9600,490,0
3,2006,1746,1746,1746,201,2,14892,758,0
2,2001,2263,1055,1055,0,1,9240,905,1208
1,1965,1565,1187,1565,200,2,8800,299,0
1,1955,960,960,960,0,0,9768,330,0
1,1964,1728,1728,1728,155,0,10624,352,0
2,2004,1959,847,847,100,1,11796,434,1112
4,2005,2790,1620,1632,30,1,12539,1150,1158
3,2005,1964,1964,1964,0,1,11447,892,0
2,2000,1573,756,769,0,0,2117,440,804
2,1963,1394,1394,1394,0,2,9500,514,0
1,1972,768,768,768,192,0,7200,396,0
2,1966,1348,660,660,188,1,7590,453,688
2,2004,1947,991,991,0,1,12552,678,956
2,1978,1096,1008,1096,168,1,13014,484,0
2,1969,1968,784,1168,305,1,11075,530,800
3,2009,1544,1544,1544,0,0,12883,868,0
1,1926,986,960,986,0,1,6180,180,0
2,2003,2486,1122,1146,143,1,11800,452,1340
2,2005,1506,1362,1506,142,1,3013,440,0
2,1962,1716,858,858,0,1,9247,490,858
3,1941,2039,929,2039,0,3,21299,791,0
1,1949,480,480,480,0,0,9000,308,0
3,1892,3608,1107,1518,0,2,22950,840,1518
3,2004,1850,1833,1850,519,1,16033,772,0
3,2006,2473,1094,1102,246,1,12292,675,1371
3,2003,1629,3206,1629,0,1,10655,880,0
2,2004,1200,600,600,0,0,3182,480,600
1,1958,912,912,912,0,0,10150,275,0
2,1975,1074,1056,1074,0,0,10140,495,0
3,2006,1830,1302,1302,0,0,8778,859,528
1,1940,672,672,672,88,0,5400,308,0
1,1950,988,876,988,0,0,7200,276,0
2,1952,1474,1632,1474,0,2,31220,495,0
1,1978,907,907,907,72,0,16269,343,0
3,2007,1542,1542,1542,168,1,11830,852,0
3,1998,2450,1284,1310,0,1,16545,1069,1140
3,2002,1654,1654,1654,0,0,8125,900,0
2,1932,1991,854,1096,0,1,11275,432,895
2,2002,1729,860,860,386,0,8158,542,869
0,1900,2200,1272,1272,0,0,8777,0,928
3,1963,1572,1572,1572,0,2,35133,995,0
2,1924,949,949,949,0,1,6000,370,0
1,1976,1304,264,616,141,1,2665,336,688
0,1955,1152,0,1152,0,0,6882,0,0
1,1950,1074,663,1074,0,1,11479,467,0
3,2005,2728,1848,1848,0,2,20431,706,880
2,2003,1342,698,698,100,1,8174,393,644
2,2000,1512,756,756,0,1,2117,440,756
3,2007,2772,1776,1794,135,3,14257,754,978
4,2000,2787,1168,1168,312,2,7939,820,1619
1,1971,1050,1043,1050,0,0,8510,336,0
3,2005,2046,1994,2046,188,2,15431,878,0
2,1966,1988,1104,1104,0,1,14670,480,884
2,1976,1479,725,725,0,0,13517,475,754
2,2001,1593,1593,1593,0,1,4923,682,0
1,1941,1210,672,832,0,0,5000,240,378
2,1995,1658,773,773,224,1,8000,431,885
2,1950,864,864,864,194,0,7200,720,0
2,1999,1416,696,696,0,0,2572,484,720
2,2007,1162,1162,1162,0,0,9260,483,0
1,1916,1656,660,808,0,0,10410,180,704
2,1971,810,782,810,0,0,10820,576,0
1,1956,1048,1048,1048,0,0,10152,286,0
1,1972,1302,630,630,0,0,1680,264,672
2,2000,1525,1525,1525,219,0,9100,541,0
2,2005,2253,1209,1209,243,1,12867,575,1044
1,1960,1269,1269,1269,0,1,7931,308,0
0,1970,1344,546,798,0,1,1533,0,546
2,1983,884,840,884,240,0,9180,504,0
3,2005,2358,1524,1544,120,1,11643,784,814
2,1957,1839,1477,1839,0,2,14442,416,0
3,2004,1884,1884,1884,214,1,15401,670,0
1,1920,1362,951,986,0,0,7550,280,376
2,1956,1728,1048,1728,0,1,13495,576,0
1,1975,938,938,938,145,0,9200,308,0
1,1962,1812,864,876,0,1,7590,264,936
0,1955,1152,0,1152,0,0,6845,0,0
1,1959,1256,1256,1256,0,0,8000,311,0
2,1978,1456,855,855,147,1,2364,440,601
1,1926,1479,624,743,530,2,7000,312,736
2,1992,1845,1055,1055,635,1,11218,462,790
2,1952,1488,0,1488,0,1,12048,569,0
2,1967,1510,1510,1510,0,0,9680,517,0
2,1957,1392,1392,1392,0,2,11900,458,0
1,1940,804,788,804,0,2,7200,240,0
2,2006,1241,1241,1241,0,0,4274,569,0
2,1974,1350,1064,1350,0,1,10140,478,0
2,2005,1500,750,750,0,0,8846,564,750
2,1976,954,911,954,0,0,10780,576,0
3,2002,1786,1778,1786,182,1,14860,715,0
1,1967,900,882,900,0,0,9819,280,0
3,1995,2113,2109,2113,236,1,10437,839,0
2,1946,1958,979,979,0,0,7136,492,979
3,2006,1694,1694,1694,0,1,11825,856,0
2,1908,2358,907,1307,486,1,45600,360,1051
3,2003,3279,1650,1690,503,1,53504,841,1589
2,2000,1652,1494,1652,96,0,5330,499,0
1,1977,894,894,894,192,0,6285,308,0
2,1978,1857,945,945,400,1,10530,482,912
2,2005,1336,1336,1336,136,0,8772,502,0
2,1991,1689,1680,1689,428,1,9990,432,0
3,1999,2312,1177,1223,298,1,15896,658,1089
1,1930,1162,728,728,0,0,6120,258,434
1,1957,1176,1176,1176,0,2,8856,292,0
3,2007,1698,1698,1698,327,1,13286,768,0
1,1936,1324,672,757,0,0,6000,240,567
0,1918,1020,1020,1020,0,0,4761,0,0
1,1900,1178,859,859,68,0,8712,384,319
2,2004,1640,798,798,138,0,8366,520,842
2,1954,1663,1364,1663,224,2,53227,529,0
2,1968,1388,1388,1388,0,1,12000,522,0
3,2006,1670,1670,1670,0,1,15218,928,0
2,1970,2217,2217,2217,81,1,15865,621,0
1,1957,1364,1179,1364,0,1,8400,331,0
2,1969,1054,1054,1054,180,0,9750,460,0
1,1924,1142,468,822,0,0,6000,320,320
1,1930,1654,297,1001,244,1,4960,336,653
2,2004,1374,384,744,100,1,11084,400,630
2,1970,768,768,768,104,0,7244,624,0
1,1982,816,816,816,0,1,6600,264,0
2,1970,2411,1008,1403,0,1,8000,570,1008
1,1936,1639,1064,1166,0,0,10480,240,0
1,1967,892,892,892,0,0,7150,288,0
1,1958,912,912,912,12,0,7535,297,0
2,1982,845,845,845,0,0,7599,360,0
2,2002,1894,817,824,0,1,11316,510,1070
1,1950,1252,1032,1032,0,0,9600,288,220
0,1945,670,370,442,0,0,3500,0,228
2,1999,1647,953,953,0,1,7917,460,694
2,1965,1728,1728,1728,0,0,11072,576,0
1,1965,894,894,894,416,1,8450,336,0
2,1981,1479,725,725,167,1,12090,484,754
2,1953,1505,1505,1505,0,1,12160,505,0
0,2006,1100,1100,1100,0,0,7500,0,0
2,2006,1486,1461,1486,0,0,7441,566,0
2,2006,1448,1372,1448,0,1,7500,692,0
2,1961,1235,1235,1235,0,0,8500,480,0
1,1970,914,914,914,120,0,7920,368,0
1,1927,1642,728,914,0,1,9863,374,728
1,1962,1040,1040,1040,0,0,6897,260,0
3,1969,1424,1100,1424,144,0,41600,828,0
2,1967,2126,1013,1160,486,0,28698,538,966
1,1970,864,864,864,0,0,9353,280,0
1,1915,1680,840,840,0,0,15576,308,840
1,1940,672,672,672,168,0,10200,240,0
2,1963,1128,1120,1128,192,0,8700,525,0
2,1993,1797,1152,1152,162,1,12961,616,645
0,1940,599,416,599,0,0,5400,0,0
2,1968,1440,720,720,192,2,11227,480,720
1,1954,833,833,833,0,0,5400,326,0
3,2001,2649,1479,1515,0,1,16900,746,1134
3,2000,2855,1540,1540,247,1,9233,774,1315
3,1932,1609,637,959,0,2,12320,579,650
2,1977,2620,1361,1361,155,1,18890,600,1259
3,2006,2322,1035,1082,400,0,12104,617,1240
2,1977,1676,1160,1676,690,2,33983,672,0
2,1991,1478,1454,1478,114,1,9928,506,0
2,2003,1456,1273,1456,143,1,3196,400,0
0,1920,720,720,720,0,0,7879,0,0
2,2004,1102,551,551,0,0,5105,480,551
2,1958,960,960,960,0,0,9750,624,0
2,1975,1701,1390,1701,0,2,16647,611,0
2,1955,1005,1005,1005,0,1,10434,672,0
2,1968,1051,1051,1051,0,0,9600,504,0
0,1914,1484,742,742,0,1,6300,0,742
